ID,County,State,Heat,Wet Bulb,Farm Crop Yields,Sea Level Rise,Very Large Fires,Economic Damages,Total Risk Score
AL - Mobile County,Mobile County,AL,6,7,8,4,2,7,34
AL - Clarke County,Clarke County,AL,7,5,9,1,1,7,30
AL - Escambia County,Escambia County,AL,6,5,8,1,1,8,29
AL - Washington County,Washington County,AL,6,5,8,3,1,7,30
AL - Baldwin County,Baldwin County,AL,6,6,5,4,1,8,30
AL - Greene County,Greene County,AL,7,7,8,1,1,5,29
AL - Monroe County,Monroe County,AL,6,5,8,1,1,7,28
AL - Pickens County,Pickens County,AL,7,7,8,1,1,5,29
AL - Sumter County,Sumter County,AL,7,7,8,1,1,5,29
AL - Autauga County,Autauga County,AL,7,4,8,1,1,6,27
AL - Butler County,Butler County,AL,6,4,8,1,1,7,27
AL - Choctaw County,Choctaw County,AL,7,5,8,1,1,6,28
AL - Conecuh County,Conecuh County,AL,6,4,8,1,1,7,27
AL - Elmore County,Elmore County,AL,7,4,8,1,1,6,27
AL - Lowndes County,Lowndes County,AL,7,6,8,1,1,5,28
AL - Marengo County,Marengo County,AL,7,5,8,1,1,6,28
AL - Perry County,Perry County,AL,6,4,8,1,1,7,27
AL - Tuscaloosa County,Tuscaloosa County,AL,7,6,8,1,1,5,28
AL - Wilcox County,Wilcox County,AL,7,4,8,1,1,6,27
AL - Covington County,Covington County,AL,6,4,8,1,1,6,26
AL - Geneva County,Geneva County,AL,6,2,8,1,1,7,25
AL - Henry County,Henry County,AL,6,2,8,1,1,7,25
AL - Montgomery County,Montgomery County,AL,7,5,8,1,1,5,27
AL - Russell County,Russell County,AL,7,4,8,1,1,6,27
AL - Coffee County,Coffee County,AL,6,2,8,1,1,6,24
AL - Crenshaw County,Crenshaw County,AL,6,2,8,1,1,6,24
AL - Dallas County,Dallas County,AL,6,4,8,1,1,6,26
AL - Hale County,Hale County,AL,6,4,8,1,1,6,26
AL - Houston County,Houston County,AL,6,4,8,1,1,6,26
AL - Lamar County,Lamar County,AL,7,4,8,1,1,5,26
AL - Macon County,Macon County,AL,6,2,8,1,1,6,24
AL - Shelby County,Shelby County,AL,6,4,8,1,2,5,26
AL - Bibb County,Bibb County,AL,6,4,8,1,1,5,25
AL - Bullock County,Bullock County,AL,6,2,8,1,1,6,24
AL - Chilton County,Chilton County,AL,6,4,8,1,1,6,26
AL - Coosa County,Coosa County,AL,6,1,8,1,1,6,23
AL - Fayette County,Fayette County,AL,7,2,8,1,1,5,24
AL - Morgan County,Morgan County,AL,7,5,7,1,1,5,26
AL - Pike County,Pike County,AL,6,4,8,1,1,5,25
AL - St. Clair County,St. Clair County,AL,6,2,8,1,2,6,25
AL - Walker County,Walker County,AL,6,2,8,1,2,5,24
AL - Barbour County,Barbour County,AL,6,2,8,1,1,5,23
AL - Blount County,Blount County,AL,6,2,7,1,2,6,24
AL - Cullman County,Cullman County,AL,6,4,7,1,2,5,25
AL - Dale County,Dale County,AL,6,2,8,1,1,5,23
AL - Lauderdale County,Lauderdale County,AL,6,4,8,1,1,5,25
AL - Lawrence County,Lawrence County,AL,6,4,8,1,1,5,25
AL - Madison County,Madison County,AL,7,4,6,1,2,5,25
AL - Marion County,Marion County,AL,7,2,8,1,1,5,24
AL - Tallapoosa County,Tallapoosa County,AL,6,2,8,1,1,5,23
AL - Clay County,Clay County,AL,6,2,8,1,1,5,23
AL - Colbert County,Colbert County,AL,6,2,8,1,1,5,23
AL - Franklin County,Franklin County,AL,6,4,7,1,1,5,24
AL - Jefferson County,Jefferson County,AL,6,2,7,1,2,5,23
AL - Talladega County,Talladega County,AL,6,2,8,1,1,5,23
AL - Calhoun County,Calhoun County,AL,6,2,6,1,2,5,22
AL - Cleburne County,Cleburne County,AL,6,2,6,1,2,5,22
AL - Etowah County,Etowah County,AL,6,2,6,1,2,5,22
AL - Limestone County,Limestone County,AL,6,4,6,1,1,5,23
AL - Chambers County,Chambers County,AL,4,1,8,1,1,5,20
AL - Jackson County,Jackson County,AL,6,2,5,1,2,5,21
AL - Randolph County,Randolph County,AL,4,1,8,1,1,5,20
AL - Winston County,Winston County,AL,6,2,6,1,1,5,21
AL - Lee County,Lee County,AL,4,1,7,1,1,5,19
AL - Marshall County,Marshall County,AL,4,2,5,1,2,5,19
AL - Cherokee County,Cherokee County,AL,4,1,4,1,2,5,17
AL - DeKalb County,DeKalb County,AL,4,1,4,1,2,5,17
AR - Franklin County,Franklin County,AR,7,7,9,1,2,4,30
AR - White County,White County,AR,7,2,8,1,6,4,28
AR - Grant County,Grant County,AR,7,9,8,1,1,4,30
AR - Lawrence County,Lawrence County,AR,6,7,8,1,2,4,28
AR - Mississippi County,Mississippi County,AR,7,7,8,1,1,5,29
AR - Pulaski County,Pulaski County,AR,7,7,8,1,1,4,28
AR - Clark County,Clark County,AR,6,6,9,1,1,4,27
AR - Little River County,Little River County,AR,7,4,9,1,1,5,27
AR - Logan County,Logan County,AR,7,4,9,1,2,4,27
AR - Miller County,Miller County,AR,7,4,9,1,1,5,27
AR - Randolph County,Randolph County,AR,6,6,8,1,2,4,27
AR - Conway County,Conway County,AR,7,4,8,1,2,4,26
AR - Craighead County,Craighead County,AR,7,6,8,1,1,4,27
AR - Crawford County,Crawford County,AR,7,4,8,1,2,4,26
AR - Crittenden County,Crittenden County,AR,7,6,7,1,1,5,27
AR - Faulkner County,Faulkner County,AR,7,4,8,1,2,4,26
AR - Hempstead County,Hempstead County,AR,7,2,9,1,1,5,25
AR - Hot Spring County,Hot Spring County,AR,7,4,8,1,2,4,26
AR - Jefferson County,Jefferson County,AR,6,7,8,1,1,4,27
AR - Lonoke County,Lonoke County,AR,6,7,8,1,1,4,27
AR - Poinsett County,Poinsett County,AR,7,6,8,1,1,4,27
AR - Saline County,Saline County,AR,6,4,8,1,2,5,26
AR - Sebastian County,Sebastian County,AR,7,4,8,1,2,4,26
AR - Chicot County,Chicot County,AR,9,4,7,1,1,5,27
AR - Cleburne County,Cleburne County,AR,6,2,8,1,3,4,24
AR - Cross County,Cross County,AR,6,6,8,1,1,4,26
AR - Desha County,Desha County,AR,7,5,7,1,1,5,26
AR - Drew County,Drew County,AR,7,2,8,1,1,5,24
AR - Fulton County,Fulton County,AR,6,4,8,1,2,4,25
AR - Johnson County,Johnson County,AR,7,2,8,1,2,4,24
AR - Lafayette County,Lafayette County,AR,7,2,8,1,1,5,24
AR - Nevada County,Nevada County,AR,6,2,10,1,1,4,24
AR - Pope County,Pope County,AR,7,2,8,1,2,4,24
AR - Yell County,Yell County,AR,7,2,8,1,2,4,24
AR - Ashley County,Ashley County,AR,7,2,8,1,1,5,24
AR - Baxter County,Baxter County,AR,6,2,8,1,2,4,23
AR - Benton County,Benton County,AR,6,2,8,1,2,4,23
AR - Clay County,Clay County,AR,6,5,8,1,1,4,25
AR - Greene County,Greene County,AR,6,4,8,1,1,4,24
AR - Independence County,Independence County,AR,6,2,8,1,2,4,23
AR - Lee County,Lee County,AR,7,4,8,1,1,4,25
AR - Perry County,Perry County,AR,6,2,8,1,2,4,23
AR - St. Francis County,St. Francis County,AR,6,4,8,1,1,4,24
AR - Washington County,Washington County,AR,6,2,8,1,3,4,24
AR - Woodruff County,Woodruff County,AR,7,4,8,1,1,4,25
AR - Arkansas County,Arkansas County,AR,7,2,7,1,1,5,23
AR - Cleveland County,Cleveland County,AR,6,2,8,1,1,4,22
AR - Izard County,Izard County,AR,6,1,8,1,2,4,22
AR - Lincoln County,Lincoln County,AR,7,2,7,1,1,5,23
AR - Prairie County,Prairie County,AR,7,2,8,1,1,4,23
AR - Jackson County,Jackson County,AR,6,2,8,1,1,4,22
AR - Monroe County,Monroe County,AR,7,2,7,1,1,4,22
AR - Phillips County,Phillips County,AR,7,2,7,1,1,4,22
AR - Dallas County,Dallas County,AR,6,7,1,1,1,4,20
AR - Bradley County,Bradley County,AR,7,4,1,1,1,5,19
AR - Garland County,Garland County,AR,7,4,1,1,2,4,19
AR - Ouachita County,Ouachita County,AR,7,4,1,1,1,5,19
AR - Van Buren County,Van Buren County,AR,6,5,1,1,2,4,19
AR - Columbia County,Columbia County,AR,7,2,1,1,1,5,17
AR - Howard County,Howard County,AR,7,4,1,1,1,4,18
AR - Montgomery County,Montgomery County,AR,6,4,1,1,2,4,18
AR - Pike County,Pike County,AR,7,4,1,1,1,4,18
AR - Polk County,Polk County,AR,7,2,1,1,2,4,17
AR - Scott County,Scott County,AR,7,2,1,1,2,4,17
AR - Sharp County,Sharp County,AR,6,4,1,1,2,4,18
AR - Union County,Union County,AR,7,2,1,1,1,5,17
AR - Calhoun County,Calhoun County,AR,6,2,1,1,1,5,16
AR - Searcy County,Searcy County,AR,6,2,1,1,2,4,16
AR - Sevier County,Sevier County,AR,7,2,1,1,1,4,16
AR - Carroll County,Carroll County,AR,4,2,1,1,2,4,14
AR - Madison County,Madison County,AR,4,2,1,1,2,4,14
AR - Stone County,Stone County,AR,6,1,1,1,2,4,15
AR - Boone County,Boone County,AR,4,1,1,1,2,4,13
AR - Marion County,Marion County,AR,4,1,1,1,2,4,13
AR - Newton County,Newton County,AR,3,1,1,1,2,4,12
AZ - Pinal County,Pinal County,AZ,10,6,8,1,6,7,38
AZ - Graham County,Graham County,AZ,10,2,8,1,8,6,35
AZ - Cochise County,Cochise County,AZ,7,2,8,1,9,6,33
AZ - Mohave County,Mohave County,AZ,10,6,1,1,9,7,34
AZ - Maricopa County,Maricopa County,AZ,10,7,8,1,1,6,33
AZ - Yuma County,Yuma County,AZ,10,7,8,1,1,6,33
AZ - Gila County,Gila County,AZ,10,5,1,1,7,5,29
AZ - Yavapai County,Yavapai County,AZ,4,1,7,1,7,5,25
AZ - Greenlee County,Greenlee County,AZ,7,1,6,1,6,5,26
AZ - Pima County,Pima County,AZ,10,2,1,1,7,6,27
AZ - La Paz County,La Paz County,AZ,10,7,1,1,1,7,27
AZ - Navajo County,Navajo County,AZ,7,1,4,1,6,5,24
AZ - Coconino County,Coconino County,AZ,3,1,1,1,9,5,20
AZ - Santa Cruz County,Santa Cruz County,AZ,9,1,1,1,6,5,23
AZ - Apache County,Apache County,AZ,4,1,1,1,6,5,18
CA - Fresno County,Fresno County,CA,9,4,8,1,8,5,35
CA - Tehama County,Tehama County,CA,9,4,8,1,7,5,34
CA - Shasta County,Shasta County,CA,7,4,6,1,9,5,32
CA - Imperial County,Imperial County,CA,10,7,8,1,1,5,32
CA - Madera County,Madera County,CA,7,2,8,1,6,5,29
CA - Amador County,Amador County,CA,7,2,8,1,6,5,29
CA - Butte County,Butte County,CA,6,2,8,1,6,5,28
CA - Riverside County,Riverside County,CA,10,6,8,1,1,5,31
CA - El Dorado County,El Dorado County,CA,4,2,6,1,8,5,26
CA - San Bernardino County,San Bernardino County,CA,10,5,8,1,1,5,30
CA - Merced County,Merced County,CA,9,2,4,1,6,5,27
CA - Nevada County,Nevada County,CA,4,2,6,1,7,5,25
CA - Placer County,Placer County,CA,4,2,5,1,7,5,24
CA - Tulare County,Tulare County,CA,9,2,8,1,1,5,26
CA - Glenn County,Glenn County,CA,7,2,8,1,1,5,24
CA - Kings County,Kings County,CA,9,2,8,1,1,5,26
CA - Los Angeles County,Los Angeles County,CA,4,2,4,3,6,5,24
CA - Mendocino County,Mendocino County,CA,4,1,3,3,8,5,24
CA - Modoc County,Modoc County,CA,4,1,4,1,9,4,23
CA - Santa Barbara County,Santa Barbara County,CA,7,2,3,3,6,4,25
CA - Trinity County,Trinity County,CA,7,4,1,1,9,4,26
CA - Tuolumne County,Tuolumne County,CA,4,1,5,1,7,5,23
CA - Yolo County,Yolo County,CA,9,2,4,4,3,5,27
CA - Colusa County,Colusa County,CA,7,2,8,1,1,5,24
CA - San Diego County,San Diego County,CA,3,1,4,4,6,5,23
CA - Solano County,Solano County,CA,9,2,3,4,3,5,26
CA - Sonoma County,Sonoma County,CA,6,5,3,4,3,5,26
CA - Santa Clara County,Santa Clara County,CA,3,2,3,4,6,5,23
CA - Siskiyou County,Siskiyou County,CA,6,1,1,1,10,4,23
CA - Lassen County,Lassen County,CA,4,1,1,1,10,4,21
CA - Sacramento County,Sacramento County,CA,7,2,4,4,1,5,23
CA - San Benito County,San Benito County,CA,4,2,3,1,6,5,21
CA - San Joaquin County,San Joaquin County,CA,7,2,4,4,1,5,23
CA - San Luis Obispo County,San Luis Obispo County,CA,3,1,3,3,6,5,21
CA - Sutter County,Sutter County,CA,7,2,6,1,1,5,22
CA - Yuba County,Yuba County,CA,4,2,8,1,1,5,21
CA - Kern County,Kern County,CA,4,1,8,1,1,5,20
CA - Orange County,Orange County,CA,4,2,3,4,3,5,21
CA - Plumas County,Plumas County,CA,4,1,1,1,9,4,20
CA - Lake County,Lake County,CA,7,1,1,1,6,5,21
CA - Napa County,Napa County,CA,4,1,3,3,4,5,20
CA - Stanislaus County,Stanislaus County,CA,7,2,4,1,1,5,20
CA - Ventura County,Ventura County,CA,3,2,1,3,6,5,20
CA - Contra Costa County,Contra Costa County,CA,6,1,3,3,2,5,20
CA - Inyo County,Inyo County,CA,10,4,1,1,1,5,22
CA - Mariposa County,Mariposa County,CA,4,1,1,1,6,5,18
CA - San Mateo County,San Mateo County,CA,3,1,3,7,2,4,20
CA - Sierra County,Sierra County,CA,4,1,1,1,7,4,18
CA - Calaveras County,Calaveras County,CA,3,1,1,1,6,5,17
CA - Monterey County,Monterey County,CA,4,2,3,3,1,5,18
CA - Alameda County,Alameda County,CA,6,1,1,4,3,4,19
CA - Mono County,Mono County,CA,3,1,1,1,6,4,16
CA - Alpine County,Alpine County,CA,3,1,1,1,6,4,16
CA - Humboldt County,Humboldt County,CA,1,1,3,4,1,4,14
CA - Marin County,Marin County,CA,4,1,1,4,1,4,15
CA - San Francisco County,San Francisco County,CA,3,2,1,4,1,4,15
CA - Del Norte County,Del Norte County,CA,1,1,1,4,1,4,12
CA - Santa Cruz County,Santa Cruz County,CA,3,1,1,3,1,4,13
CO - Mesa County,Mesa County,CO,7,2,4,1,7,4,25
CO - Baca County,Baca County,CO,7,2,6,1,3,5,24
CO - Prowers County,Prowers County,CO,7,2,7,1,2,5,24
CO - Bent County,Bent County,CO,7,2,6,1,2,5,23
CO - Cheyenne County,Cheyenne County,CO,7,2,5,1,2,5,22
CO - Kiowa County,Kiowa County,CO,7,2,5,1,2,5,22
CO - Otero County,Otero County,CO,7,1,5,1,2,5,21
CO - Crowley County,Crowley County,CO,7,1,4,1,2,5,20
CO - Larimer County,Larimer County,CO,4,1,3,1,6,4,19
CO - Las Animas County,Las Animas County,CO,4,1,3,1,6,4,19
CO - Montezuma County,Montezuma County,CO,4,1,3,1,6,4,19
CO - Montrose County,Montrose County,CO,3,1,3,1,6,4,18
CO - Boulder County,Boulder County,CO,4,1,3,1,5,4,18
CO - Delta County,Delta County,CO,4,1,3,1,5,4,18
CO - Kit Carson County,Kit Carson County,CO,7,2,4,1,1,4,19
CO - La Plata County,La Plata County,CO,3,1,3,1,6,4,18
CO - Moffat County,Moffat County,CO,6,1,1,1,6,4,19
CO - Pueblo County,Pueblo County,CO,7,1,3,1,3,4,19
CO - Dolores County,Dolores County,CO,4,1,3,1,4,4,17
CO - Garfield County,Garfield County,CO,4,1,1,1,6,4,17
CO - Logan County,Logan County,CO,6,2,4,1,1,4,18
CO - Rio Blanco County,Rio Blanco County,CO,4,1,1,1,6,4,17
CO - Adams County,Adams County,CO,6,1,3,1,2,4,17
CO - Arapahoe County,Arapahoe County,CO,6,1,3,1,2,4,17
CO - Broomfield County,Broomfield County,CO,6,1,3,1,2,4,17
CO - Jefferson County,Jefferson County,CO,3,1,3,1,4,4,16
CO - Lincoln County,Lincoln County,CO,4,1,3,1,3,4,16
CO - Morgan County,Morgan County,CO,6,1,4,1,1,4,17
CO - Sedgwick County,Sedgwick County,CO,6,1,4,1,1,4,17
CO - Washington County,Washington County,CO,6,1,4,1,1,4,17
CO - Weld County,Weld County,CO,4,1,3,1,3,4,16
CO - Yuma County,Yuma County,CO,6,1,4,1,1,4,17
CO - Archuleta County,Archuleta County,CO,3,1,1,1,6,4,16
CO - Douglas County,Douglas County,CO,3,1,3,1,3,4,15
CO - Elbert County,Elbert County,CO,4,1,3,1,2,4,15
CO - Fremont County,Fremont County,CO,3,1,1,1,6,4,16
CO - Gunnison County,Gunnison County,CO,1,1,1,1,6,4,14
CO - Phillips County,Phillips County,CO,4,1,4,1,1,4,15
CO - Routt County,Routt County,CO,3,1,1,1,6,4,16
CO - El Paso County,El Paso County,CO,3,1,3,1,2,4,14
CO - Huerfano County,Huerfano County,CO,4,1,1,1,4,4,15
CO - Saguache County,Saguache County,CO,3,1,1,1,5,4,15
CO - Eagle County,Eagle County,CO,3,1,1,1,4,4,14
CO - San Miguel County,San Miguel County,CO,3,1,1,1,4,4,14
CO - Conejos County,Conejos County,CO,3,1,1,1,3,4,13
CO - Costilla County,Costilla County,CO,3,1,1,1,3,4,13
CO - Custer County,Custer County,CO,3,1,1,1,3,4,13
CO - Denver County,Denver County,CO,4,1,1,1,2,4,13
CO - Jackson County,Jackson County,CO,3,1,1,1,3,4,13
CO - Pitkin County,Pitkin County,CO,3,1,1,1,3,4,13
CO - Teller County,Teller County,CO,3,1,1,1,3,4,13
CO - Alamosa County,Alamosa County,CO,3,1,1,1,2,4,12
CO - Chaffee County,Chaffee County,CO,1,1,1,1,3,4,11
CO - Mineral County,Mineral County,CO,1,1,1,1,3,4,11
CO - Ouray County,Ouray County,CO,1,1,1,1,3,4,11
CO - Rio Grande County,Rio Grande County,CO,1,1,1,1,3,4,11
CO - Clear Creek County,Clear Creek County,CO,1,1,1,1,2,4,10
CO - Gilpin County,Gilpin County,CO,1,1,1,1,2,4,10
CO - Hinsdale County,Hinsdale County,CO,3,1,1,1,3,2,11
CO - Lake County,Lake County,CO,1,1,1,1,2,4,10
CO - Park County,Park County,CO,1,1,1,1,5,1,10
CO - San Juan County,San Juan County,CO,1,1,1,1,2,4,10
CO - Grand County,Grand County,CO,1,1,1,1,3,2,9
CO - Summit County,Summit County,CO,1,1,1,1,2,3,9
CT - Fairfield County,Fairfield County,CT,3,5,1,4,1,5,19
CT - Middlesex County,Middlesex County,CT,3,5,1,4,1,4,18
CT - New Haven County,New Haven County,CT,3,5,1,4,1,4,18
CT - Hartford County,Hartford County,CT,4,5,1,1,1,4,16
CT - New London County,New London County,CT,3,2,1,4,1,4,15
CT - Tolland County,Tolland County,CT,3,4,1,1,1,4,14
CT - Windham County,Windham County,CT,3,4,1,1,1,4,14
CT - Litchfield County,Litchfield County,CT,3,2,1,1,1,4,12
DC - District of Columbia,District of Columbia,DC,6,2,1,3,1,4,17
DE - Kent County,Kent County,DE,4,4,5,4,3,4,24
DE - Sussex County,Sussex County,DE,4,4,5,6,1,5,25
DE - New Castle County,New Castle County,DE,4,2,4,3,1,4,18
FL - Wakulla County,Wakulla County,FL,7,9,8,4,1,9,38
FL - Marion County,Marion County,FL,9,4,8,3,4,8,36
FL - Miami-Dade County,Miami-Dade County,FL,4,5,8,4,6,8,35
FL - Palm Beach County,Palm Beach County,FL,4,4,8,4,6,8,34
FL - Dixie County,Dixie County,FL,7,6,7,4,1,10,35
FL - St. Johns County,St. Johns County,FL,6,6,8,4,2,8,34
FL - Taylor County,Taylor County,FL,7,6,8,4,1,8,34
FL - Volusia County,Volusia County,FL,4,6,8,4,3,9,34
FL - Duval County,Duval County,FL,6,6,7,4,3,8,34
FL - Glades County,Glades County,FL,9,1,8,3,3,9,33
FL - Levy County,Levy County,FL,6,4,8,4,1,10,33
FL - Pasco County,Pasco County,FL,9,5,8,3,3,7,35
FL - Gilchrist County,Gilchrist County,FL,6,5,8,3,2,8,32
FL - Lafayette County,Lafayette County,FL,7,5,8,1,2,8,31
FL - Lake County,Lake County,FL,6,2,8,4,3,8,31
FL - Putnam County,Putnam County,FL,4,2,8,4,3,9,30
FL - Baker County,Baker County,FL,6,4,8,1,3,8,30
FL - Collier County,Collier County,FL,6,4,8,4,1,8,31
FL - Flagler County,Flagler County,FL,4,4,8,4,2,8,30
FL - Highlands County,Highlands County,FL,9,1,8,1,3,8,30
FL - Leon County,Leon County,FL,7,7,8,1,1,7,31
FL - Madison County,Madison County,FL,7,5,8,1,2,8,31
FL - Polk County,Polk County,FL,7,2,8,1,5,6,29
FL - Suwannee County,Suwannee County,FL,7,5,8,1,1,8,30
FL - Columbia County,Columbia County,FL,6,4,8,1,3,7,29
FL - Hamilton County,Hamilton County,FL,7,4,8,1,1,8,29
FL - Jefferson County,Jefferson County,FL,7,7,5,1,2,8,30
FL - Liberty County,Liberty County,FL,4,5,8,3,1,8,29
FL - Union County,Union County,FL,6,4,8,1,2,8,29
FL - Alachua County,Alachua County,FL,6,2,8,1,3,7,27
FL - Bay County,Bay County,FL,4,4,8,4,1,7,28
FL - Bradford County,Bradford County,FL,6,2,8,1,2,8,27
FL - Clay County,Clay County,FL,6,5,3,4,3,9,30
FL - Gadsden County,Gadsden County,FL,7,4,8,1,1,7,28
FL - Hardee County,Hardee County,FL,9,2,8,1,3,5,28
FL - Hillsborough County,Hillsborough County,FL,6,4,8,4,3,5,30
FL - Charlotte County,Charlotte County,FL,9,6,1,4,2,8,30
FL - Monroe County,Monroe County,FL,4,5,1,7,4,8,29
FL - Broward County,Broward County,FL,4,4,1,4,6,8,27
FL - DeSoto County,DeSoto County,FL,9,5,1,4,2,8,29
FL - Escambia County,Escambia County,FL,4,7,3,3,1,8,26
FL - Franklin County,Franklin County,FL,4,6,1,4,2,10,27
FL - Lee County,Lee County,FL,9,6,1,4,1,8,29
FL - Nassau County,Nassau County,FL,6,6,1,4,3,8,28
FL - Santa Rosa County,Santa Rosa County,FL,4,7,3,4,1,8,27
FL - Walton County,Walton County,FL,6,4,3,4,3,8,28
FL - Washington County,Washington County,FL,4,2,6,3,1,9,25
FL - Citrus County,Citrus County,FL,9,4,1,4,1,9,28
FL - Hernando County,Hernando County,FL,9,5,1,4,1,8,28
FL - Martin County,Martin County,FL,4,6,1,4,3,8,26
FL - Calhoun County,Calhoun County,FL,4,2,5,1,1,9,22
FL - Jackson County,Jackson County,FL,4,2,8,1,1,6,22
FL - Okaloosa County,Okaloosa County,FL,6,5,3,3,2,7,26
FL - Hendry County,Hendry County,FL,6,4,1,1,3,9,24
FL - Okeechobee County,Okeechobee County,FL,9,2,1,1,3,8,24
FL - Pinellas County,Pinellas County,FL,6,7,1,4,1,6,25
FL - St. Lucie County,St. Lucie County,FL,4,5,1,4,2,8,24
FL - Sumter County,Sumter County,FL,9,4,1,1,2,8,25
FL - Gulf County,Gulf County,FL,4,4,1,3,1,10,23
FL - Holmes County,Holmes County,FL,4,2,4,1,1,8,20
FL - Brevard County,Brevard County,FL,4,1,1,4,3,8,21
FL - Orange County,Orange County,FL,7,2,1,3,3,6,22
FL - Osceola County,Osceola County,FL,6,2,1,1,3,8,21
FL - Seminole County,Seminole County,FL,7,4,1,3,2,6,23
FL - Indian River County,Indian River County,FL,4,1,1,4,2,8,20
FL - Sarasota County,Sarasota County,FL,7,4,1,4,1,5,22
FL - Manatee County,Manatee County,FL,7,4,1,4,1,4,21
GA - Camden County,Camden County,GA,6,9,8,4,2,8,37
GA - Charlton County,Charlton County,GA,9,6,8,1,3,8,35
GA - Liberty County,Liberty County,GA,7,9,9,4,2,6,37
GA - Effingham County,Effingham County,GA,6,6,9,3,3,7,34
GA - Bryan County,Bryan County,GA,7,2,8,4,3,8,32
GA - Glynn County,Glynn County,GA,6,5,8,6,1,8,34
GA - Ware County,Ware County,GA,7,5,9,1,3,7,32
GA - Brantley County,Brantley County,GA,7,4,9,1,2,8,31
GA - Long County,Long County,GA,7,4,8,1,3,8,31
GA - Echols County,Echols County,GA,7,4,8,1,2,8,30
GA - Pierce County,Pierce County,GA,7,2,9,1,3,6,28
GA - Screven County,Screven County,GA,7,2,8,1,3,6,27
GA - Appling County,Appling County,GA,7,4,8,1,3,5,28
GA - Atkinson County,Atkinson County,GA,7,2,9,1,2,6,27
GA - Bacon County,Bacon County,GA,7,2,9,1,3,5,27
GA - Berrien County,Berrien County,GA,7,2,9,1,2,6,27
GA - Clinch County,Clinch County,GA,7,2,8,1,3,6,27
GA - Evans County,Evans County,GA,7,2,9,1,1,6,26
GA - Lanier County,Lanier County,GA,7,2,8,1,2,6,26
GA - McIntosh County,McIntosh County,GA,6,9,1,4,2,9,31
GA - Wayne County,Wayne County,GA,7,4,8,1,3,5,28
GA - Baker County,Baker County,GA,7,4,8,1,1,6,27
GA - Candler County,Candler County,GA,7,2,8,1,1,6,25
GA - Cook County,Cook County,GA,7,2,9,1,1,6,26
GA - Grady County,Grady County,GA,7,5,8,1,1,5,27
GA - Jeff Davis County,Jeff Davis County,GA,7,2,9,1,2,5,26
GA - Jenkins County,Jenkins County,GA,6,2,9,1,1,6,25
GA - Montgomery County,Montgomery County,GA,7,2,8,1,1,6,25
GA - Seminole County,Seminole County,GA,7,2,8,1,1,7,26
GA - Thomas County,Thomas County,GA,7,4,8,1,1,6,27
GA - Treutlen County,Treutlen County,GA,7,2,9,1,1,6,26
GA - Wheeler County,Wheeler County,GA,7,2,9,1,1,6,26
GA - Bulloch County,Bulloch County,GA,7,2,8,1,1,6,25
GA - Coffee County,Coffee County,GA,7,2,9,1,1,5,25
GA - Decatur County,Decatur County,GA,7,2,8,1,1,6,25
GA - Johnson County,Johnson County,GA,7,2,8,1,1,6,25
GA - Lowndes County,Lowndes County,GA,7,2,7,1,3,6,26
GA - Tattnall County,Tattnall County,GA,7,2,8,1,1,6,25
GA - Worth County,Worth County,GA,7,2,8,1,1,6,25
GA - Ben Hill County,Ben Hill County,GA,6,2,9,1,1,5,24
GA - Bibb County,Bibb County,GA,7,2,8,1,1,5,24
GA - Brooks County,Brooks County,GA,7,4,5,1,1,7,25
GA - Burke County,Burke County,GA,7,2,8,1,1,5,24
GA - Catoosa County,Catoosa County,GA,6,2,8,1,2,5,24
GA - Clay County,Clay County,GA,6,2,8,1,1,6,24
GA - Crawford County,Crawford County,GA,7,2,8,1,1,5,24
GA - Dougherty County,Dougherty County,GA,7,2,8,1,1,5,24
GA - Houston County,Houston County,GA,7,2,8,1,1,5,24
GA - Laurens County,Laurens County,GA,7,2,8,1,1,5,24
GA - Lee County,Lee County,GA,7,2,8,1,1,5,24
GA - Mitchell County,Mitchell County,GA,7,2,8,1,1,5,24
GA - Peach County,Peach County,GA,7,2,8,1,1,5,24
GA - Richmond County,Richmond County,GA,7,2,8,1,1,5,24
GA - Telfair County,Telfair County,GA,6,2,9,1,1,5,24
GA - Toombs County,Toombs County,GA,7,2,8,1,1,5,24
GA - Twiggs County,Twiggs County,GA,7,2,8,1,1,5,24
GA - Wilkinson County,Wilkinson County,GA,7,2,8,1,1,5,24
GA - Bleckley County,Bleckley County,GA,6,2,8,1,1,5,23
GA - Colquitt County,Colquitt County,GA,7,1,8,1,1,5,23
GA - Dodge County,Dodge County,GA,6,2,8,1,1,5,23
GA - Early County,Early County,GA,6,2,8,1,1,5,23
GA - Emanuel County,Emanuel County,GA,6,2,8,1,1,5,23
GA - Glascock County,Glascock County,GA,6,2,8,1,1,5,23
GA - Greene County,Greene County,GA,6,2,8,1,1,5,23
GA - Irwin County,Irwin County,GA,6,2,8,1,1,5,23
GA - Jefferson County,Jefferson County,GA,6,2,8,1,1,5,23
GA - Marion County,Marion County,GA,6,1,8,1,1,6,23
GA - Miller County,Miller County,GA,6,2,8,1,1,6,24
GA - Pulaski County,Pulaski County,GA,6,2,8,1,1,5,23
GA - Tift County,Tift County,GA,6,1,9,1,1,5,23
GA - Warren County,Warren County,GA,6,2,8,1,1,5,23
GA - Washington County,Washington County,GA,6,2,8,1,1,5,23
GA - Webster County,Webster County,GA,6,2,8,1,1,5,23
GA - Whitfield County,Whitfield County,GA,6,2,8,1,2,5,24
GA - Wilcox County,Wilcox County,GA,6,2,8,1,1,5,23
GA - Calhoun County,Calhoun County,GA,6,1,8,1,1,5,22
GA - Chatham County,Chatham County,GA,6,2,1,6,3,7,25
GA - Columbia County,Columbia County,GA,6,2,8,1,1,5,23
GA - Crisp County,Crisp County,GA,6,1,8,1,1,5,22
GA - Dooly County,Dooly County,GA,6,1,8,1,1,5,22
GA - Fayette County,Fayette County,GA,6,1,8,1,1,5,22
GA - Harris County,Harris County,GA,7,2,7,1,1,5,23
GA - Jasper County,Jasper County,GA,6,1,8,1,1,5,22
GA - Macon County,Macon County,GA,6,1,8,1,1,5,22
GA - Rockdale County,Rockdale County,GA,6,1,8,1,1,5,22
GA - Schley County,Schley County,GA,6,1,8,1,1,5,22
GA - Stewart County,Stewart County,GA,6,1,8,1,1,5,22
GA - Sumter County,Sumter County,GA,6,1,8,1,1,5,22
GA - Talbot County,Talbot County,GA,6,1,8,1,1,5,22
GA - Taylor County,Taylor County,GA,6,2,8,1,1,5,23
GA - Terrell County,Terrell County,GA,6,1,8,1,1,5,22
GA - Turner County,Turner County,GA,6,1,8,1,1,5,22
GA - Walton County,Walton County,GA,6,1,8,1,1,5,22
GA - Wilkes County,Wilkes County,GA,6,1,8,1,1,5,22
GA - Barrow County,Barrow County,GA,6,1,8,1,1,5,22
GA - Carroll County,Carroll County,GA,4,1,8,1,1,5,20
GA - Dade County,Dade County,GA,4,2,7,1,2,5,21
GA - Haralson County,Haralson County,GA,4,1,8,1,2,5,21
GA - Heard County,Heard County,GA,4,1,8,1,1,5,20
GA - Meriwether County,Meriwether County,GA,6,1,8,1,1,5,22
GA - Monroe County,Monroe County,GA,6,1,8,1,1,5,22
GA - Putnam County,Putnam County,GA,7,2,6,1,1,5,22
GA - Randolph County,Randolph County,GA,6,1,8,1,1,5,22
GA - Troup County,Troup County,GA,4,1,8,1,1,5,20
GA - Upson County,Upson County,GA,6,1,8,1,1,5,22
GA - Walker County,Walker County,GA,6,2,6,1,2,5,22
GA - Floyd County,Floyd County,GA,6,2,5,1,2,5,21
GA - Gwinnett County,Gwinnett County,GA,4,1,8,1,1,5,20
GA - Henry County,Henry County,GA,6,1,7,1,1,5,21
GA - Lamar County,Lamar County,GA,6,1,7,1,1,5,21
GA - Butts County,Butts County,GA,6,1,6,1,1,5,20
GA - Gordon County,Gordon County,GA,6,2,4,1,2,5,20
GA - Morgan County,Morgan County,GA,6,1,6,1,1,5,20
GA - Newton County,Newton County,GA,6,1,6,1,1,5,20
GA - Oglethorpe County,Oglethorpe County,GA,6,1,6,1,1,5,20
GA - Paulding County,Paulding County,GA,6,1,6,1,1,5,20
GA - Pike County,Pike County,GA,6,1,6,1,1,5,20
GA - Polk County,Polk County,GA,6,1,5,1,2,5,20
GA - Spalding County,Spalding County,GA,6,1,6,1,1,5,20
GA - Bartow County,Bartow County,GA,6,1,4,1,2,5,19
GA - Chattooga County,Chattooga County,GA,4,1,5,1,2,5,18
GA - Cherokee County,Cherokee County,GA,3,1,7,1,1,5,18
GA - Elbert County,Elbert County,GA,4,1,6,1,1,5,18
GA - Murray County,Murray County,GA,4,1,5,1,2,5,18
GA - Coweta County,Coweta County,GA,4,1,5,1,1,5,17
GA - Douglas County,Douglas County,GA,6,1,4,1,1,5,18
GA - Fulton County,Fulton County,GA,6,1,4,1,1,5,18
GA - Hart County,Hart County,GA,4,1,5,1,1,5,17
GA - Oconee County,Oconee County,GA,6,1,4,1,1,5,18
GA - Franklin County,Franklin County,GA,4,1,4,1,1,5,16
GA - Madison County,Madison County,GA,6,1,3,1,1,5,17
GA - Quitman County,Quitman County,GA,6,2,1,1,1,6,17
GA - Stephens County,Stephens County,GA,3,1,5,1,1,5,16
GA - Baldwin County,Baldwin County,GA,7,2,1,1,1,5,17
GA - Banks County,Banks County,GA,4,1,3,1,1,5,15
GA - Chattahoochee County,Chattahoochee County,GA,7,2,1,1,1,5,17
GA - Dawson County,Dawson County,GA,3,1,4,1,1,5,15
GA - Forsyth County,Forsyth County,GA,4,1,3,1,1,5,15
GA - Hall County,Hall County,GA,4,1,3,1,1,5,15
GA - Jackson County,Jackson County,GA,4,1,3,1,1,5,15
GA - Jones County,Jones County,GA,7,2,1,1,1,5,17
GA - Muscogee County,Muscogee County,GA,7,2,1,1,1,5,17
GA - Pickens County,Pickens County,GA,3,1,5,1,1,4,15
GA - Union County,Union County,GA,4,1,3,1,2,4,15
GA - Fannin County,Fannin County,GA,3,1,3,1,2,4,14
GA - Hancock County,Hancock County,GA,6,2,1,1,1,5,16
GA - Lincoln County,Lincoln County,GA,6,2,1,1,1,5,16
GA - Lumpkin County,Lumpkin County,GA,4,1,3,1,1,4,14
GA - Rabun County,Rabun County,GA,3,1,3,1,2,4,14
GA - Taliaferro County,Taliaferro County,GA,6,2,1,1,1,5,16
GA - Towns County,Towns County,GA,3,1,3,1,2,4,14
GA - Clarke County,Clarke County,GA,6,1,1,1,1,5,15
GA - Clayton County,Clayton County,GA,6,1,1,1,1,5,15
GA - Cobb County,Cobb County,GA,6,1,1,1,1,5,15
GA - DeKalb County,DeKalb County,GA,6,1,1,1,1,5,15
GA - Gilmer County,Gilmer County,GA,3,1,3,1,1,4,13
GA - Habersham County,Habersham County,GA,3,1,3,1,1,4,13
GA - McDuffie County,McDuffie County,GA,6,1,1,1,1,5,15
GA - White County,White County,GA,3,1,3,1,1,4,13
IA - Van Buren County,Van Buren County,IA,6,5,5,1,2,5,24
IA - Jefferson County,Jefferson County,IA,4,6,5,1,2,4,22
IA - Davis County,Davis County,IA,4,4,5,1,2,5,21
IA - Lee County,Lee County,IA,4,5,5,1,1,5,21
IA - Muscatine County,Muscatine County,IA,4,6,4,1,1,5,21
IA - Appanoose County,Appanoose County,IA,4,4,4,1,2,5,20
IA - Calhoun County,Calhoun County,IA,4,5,4,1,1,5,20
IA - Decatur County,Decatur County,IA,4,4,4,1,2,5,20
IA - Henry County,Henry County,IA,4,4,4,1,2,5,20
IA - Jasper County,Jasper County,IA,4,5,4,1,1,5,20
IA - Louisa County,Louisa County,IA,4,5,4,1,1,5,20
IA - Lucas County,Lucas County,IA,4,4,4,1,2,5,20
IA - Monroe County,Monroe County,IA,4,4,4,1,2,5,20
IA - Polk County,Polk County,IA,4,5,4,1,1,5,20
IA - Pottawattamie County,Pottawattamie County,IA,6,2,5,1,1,5,20
IA - Wapello County,Wapello County,IA,4,4,5,1,2,4,20
IA - Washington County,Washington County,IA,4,5,4,1,1,5,20
IA - Wayne County,Wayne County,IA,4,4,4,1,2,5,20
IA - Audubon County,Audubon County,IA,4,4,4,1,1,5,19
IA - Black Hawk County,Black Hawk County,IA,4,6,3,1,1,4,19
IA - Boone County,Boone County,IA,4,4,4,1,1,5,19
IA - Bremer County,Bremer County,IA,4,6,3,1,1,4,19
IA - Carroll County,Carroll County,IA,4,4,4,1,1,5,19
IA - Cedar County,Cedar County,IA,4,5,3,1,1,5,19
IA - Crawford County,Crawford County,IA,4,4,4,1,1,5,19
IA - Dallas County,Dallas County,IA,4,4,4,1,1,5,19
IA - Des Moines County,Des Moines County,IA,4,5,4,1,1,4,19
IA - Fremont County,Fremont County,IA,4,2,5,1,1,5,18
IA - Greene County,Greene County,IA,4,4,4,1,1,5,19
IA - Hamilton County,Hamilton County,IA,4,5,3,1,1,5,19
IA - Harrison County,Harrison County,IA,4,2,5,1,1,5,18
IA - Humboldt County,Humboldt County,IA,4,5,3,1,1,5,19
IA - Ida County,Ida County,IA,4,4,4,1,1,5,19
IA - Johnson County,Johnson County,IA,4,4,4,1,1,5,19
IA - Keokuk County,Keokuk County,IA,4,4,4,1,1,5,19
IA - Mahaska County,Mahaska County,IA,4,4,4,1,1,5,19
IA - Marion County,Marion County,IA,4,4,4,1,1,5,19
IA - Mills County,Mills County,IA,4,2,5,1,1,5,18
IA - Page County,Page County,IA,4,2,5,1,1,5,18
IA - Pocahontas County,Pocahontas County,IA,4,5,3,1,1,5,19
IA - Scott County,Scott County,IA,4,5,4,1,1,4,19
IA - Shelby County,Shelby County,IA,4,4,4,1,1,5,19
IA - Story County,Story County,IA,4,5,4,1,1,4,19
IA - Warren County,Warren County,IA,4,4,4,1,1,5,19
IA - Webster County,Webster County,IA,4,5,4,1,1,4,19
IA - Adair County,Adair County,IA,4,2,4,1,1,5,17
IA - Adams County,Adams County,IA,4,2,4,1,1,5,17
IA - Benton County,Benton County,IA,4,4,3,1,1,5,18
IA - Cerro Gordo County,Cerro Gordo County,IA,4,5,3,1,1,4,18
IA - Clarke County,Clarke County,IA,4,1,4,1,2,5,17
IA - Clay County,Clay County,IA,4,5,3,1,1,4,18
IA - Clinton County,Clinton County,IA,3,4,3,1,2,5,18
IA - Franklin County,Franklin County,IA,4,5,3,1,1,4,18
IA - Grundy County,Grundy County,IA,4,5,3,1,1,4,18
IA - Guthrie County,Guthrie County,IA,4,2,4,1,1,5,17
IA - Hardin County,Hardin County,IA,4,5,3,1,1,4,18
IA - Iowa County,Iowa County,IA,4,4,3,1,1,5,18
IA - Jackson County,Jackson County,IA,4,4,3,1,2,4,18
IA - Madison County,Madison County,IA,4,2,4,1,1,5,17
IA - Marshall County,Marshall County,IA,4,5,3,1,1,4,18
IA - Monona County,Monona County,IA,4,2,4,1,1,5,17
IA - Montgomery County,Montgomery County,IA,4,2,4,1,1,5,17
IA - Plymouth County,Plymouth County,IA,4,2,4,1,1,5,17
IA - Ringgold County,Ringgold County,IA,4,2,4,1,1,5,17
IA - Sac County,Sac County,IA,4,4,3,1,1,5,18
IA - Sioux County,Sioux County,IA,4,4,4,1,1,4,18
IA - Tama County,Tama County,IA,4,5,3,1,1,4,18
IA - Taylor County,Taylor County,IA,4,2,4,1,1,5,17
IA - Union County,Union County,IA,4,2,4,1,1,5,17
IA - Wright County,Wright County,IA,4,5,3,1,1,4,18
IA - Buchanan County,Buchanan County,IA,3,5,3,1,1,4,17
IA - Buena Vista County,Buena Vista County,IA,3,5,3,1,1,4,17
IA - Butler County,Butler County,IA,3,5,3,1,1,4,17
IA - Cass County,Cass County,IA,4,2,4,1,1,4,16
IA - Cherokee County,Cherokee County,IA,4,4,3,1,1,4,17
IA - Clayton County,Clayton County,IA,4,4,3,1,1,4,17
IA - Delaware County,Delaware County,IA,3,5,3,1,1,4,17
IA - Hancock County,Hancock County,IA,3,5,3,1,1,4,17
IA - Jones County,Jones County,IA,4,4,3,1,1,4,17
IA - Kossuth County,Kossuth County,IA,3,5,3,1,1,4,17
IA - Linn County,Linn County,IA,4,4,3,1,1,4,17
IA - Mitchell County,Mitchell County,IA,3,5,3,1,1,4,17
IA - Poweshiek County,Poweshiek County,IA,4,4,3,1,1,4,17
IA - Winnebago County,Winnebago County,IA,3,5,3,1,1,4,17
IA - Winneshiek County,Winneshiek County,IA,4,4,3,1,1,4,17
IA - Woodbury County,Woodbury County,IA,4,2,4,1,1,4,16
IA - Chickasaw County,Chickasaw County,IA,3,4,3,1,1,4,16
IA - Dubuque County,Dubuque County,IA,3,4,3,1,1,4,16
IA - Emmet County,Emmet County,IA,3,4,3,1,1,4,16
IA - Fayette County,Fayette County,IA,3,4,3,1,1,4,16
IA - Floyd County,Floyd County,IA,3,4,3,1,1,4,16
IA - Howard County,Howard County,IA,3,4,3,1,1,4,16
IA - Lyon County,Lyon County,IA,4,2,3,1,1,4,15
IA - O'Brien County,O'Brien County,IA,4,2,3,1,1,4,15
IA - Osceola County,Osceola County,IA,4,2,3,1,1,4,15
IA - Palo Alto County,Palo Alto County,IA,3,4,3,1,1,4,16
IA - Worth County,Worth County,IA,3,4,3,1,1,4,16
IA - Allamakee County,Allamakee County,IA,3,2,3,1,1,4,14
IA - Dickinson County,Dickinson County,IA,4,1,3,1,1,4,14
ID - Owyhee County,Owyhee County,ID,7,1,6,1,10,5,30
ID - Elmore County,Elmore County,ID,6,1,6,1,9,5,28
ID - Ada County,Ada County,ID,6,2,6,1,7,5,27
ID - Gooding County,Gooding County,ID,4,1,6,1,6,5,23
ID - Twin Falls County,Twin Falls County,ID,4,1,5,1,7,4,22
ID - Cassia County,Cassia County,ID,4,1,4,1,7,4,21
ID - Lincoln County,Lincoln County,ID,4,1,4,1,6,5,21
ID - Custer County,Custer County,ID,3,1,4,1,7,4,20
ID - Camas County,Camas County,ID,4,1,3,1,6,4,19
ID - Canyon County,Canyon County,ID,6,1,7,1,1,5,21
ID - Franklin County,Franklin County,ID,6,1,3,1,6,4,21
ID - Idaho County,Idaho County,ID,4,1,1,1,9,4,20
ID - Minidoka County,Minidoka County,ID,4,1,4,1,6,4,20
ID - Payette County,Payette County,ID,6,1,7,1,1,5,21
ID - Adams County,Adams County,ID,3,1,3,1,6,4,18
ID - Bingham County,Bingham County,ID,4,1,3,1,6,4,19
ID - Gem County,Gem County,ID,6,1,6,1,1,5,20
ID - Washington County,Washington County,ID,7,1,5,1,1,5,20
ID - Blaine County,Blaine County,ID,4,1,1,1,7,4,18
ID - Boise County,Boise County,ID,4,1,1,1,7,4,18
ID - Bonneville County,Bonneville County,ID,3,1,3,1,6,4,18
ID - Butte County,Butte County,ID,4,1,1,1,7,4,18
ID - Clearwater County,Clearwater County,ID,6,1,1,1,6,4,19
ID - Jerome County,Jerome County,ID,6,1,5,1,1,5,19
ID - Lemhi County,Lemhi County,ID,4,1,1,1,7,4,18
ID - Shoshone County,Shoshone County,ID,4,1,1,1,6,4,17
ID - Valley County,Valley County,ID,3,1,1,1,7,4,17
ID - Bonner County,Bonner County,ID,4,1,1,1,6,4,17
ID - Clark County,Clark County,ID,3,1,1,1,6,4,16
ID - Kootenai County,Kootenai County,ID,4,1,1,1,6,4,17
ID - Nez Perce County,Nez Perce County,ID,3,1,1,1,6,5,17
ID - Bear Lake County,Bear Lake County,ID,3,1,1,1,6,4,16
ID - Boundary County,Boundary County,ID,4,1,1,1,4,4,15
ID - Jefferson County,Jefferson County,ID,4,1,3,1,1,4,14
ID - Oneida County,Oneida County,ID,4,1,3,1,1,4,14
ID - Power County,Power County,ID,4,1,3,1,1,4,14
ID - Fremont County,Fremont County,ID,3,1,1,1,3,4,13
ID - Teton County,Teton County,ID,3,1,1,1,3,4,13
ID - Bannock County,Bannock County,ID,4,1,1,1,1,4,12
ID - Benewah County,Benewah County,ID,4,1,1,1,1,4,12
ID - Caribou County,Caribou County,ID,4,1,1,1,1,4,12
ID - Latah County,Latah County,ID,4,1,1,1,1,4,12
ID - Lewis County,Lewis County,ID,3,1,1,1,1,4,11
ID - Madison County,Madison County,ID,3,1,1,1,1,4,11
IL - Alexander County,Alexander County,IL,6,7,8,1,1,5,28
IL - Pulaski County,Pulaski County,IL,6,7,8,1,1,5,28
IL - Gallatin County,Gallatin County,IL,6,9,7,1,1,5,29
IL - Hardin County,Hardin County,IL,6,7,8,1,1,4,27
IL - Pope County,Pope County,IL,6,7,8,1,1,5,28
IL - Union County,Union County,IL,6,7,8,1,1,5,28
IL - Jackson County,Jackson County,IL,6,7,7,1,1,5,27
IL - Johnson County,Johnson County,IL,6,6,8,1,1,5,27
IL - Massac County,Massac County,IL,4,7,8,1,1,5,26
IL - St. Clair County,St. Clair County,IL,7,6,7,1,1,5,27
IL - Saline County,Saline County,IL,6,7,7,1,1,5,27
IL - White County,White County,IL,6,9,6,1,1,5,28
IL - Madison County,Madison County,IL,7,6,6,1,1,5,26
IL - Randolph County,Randolph County,IL,6,6,7,1,1,5,26
IL - Williamson County,Williamson County,IL,6,6,7,1,1,5,26
IL - Crawford County,Crawford County,IL,6,7,5,1,1,5,25
IL - Edwards County,Edwards County,IL,6,6,6,1,1,5,25
IL - Franklin County,Franklin County,IL,6,6,6,1,1,5,25
IL - Hamilton County,Hamilton County,IL,6,6,6,1,1,5,25
IL - Lawrence County,Lawrence County,IL,6,7,5,1,1,5,25
IL - Macon County,Macon County,IL,6,7,5,1,1,5,25
IL - Monroe County,Monroe County,IL,6,5,7,1,1,5,25
IL - Montgomery County,Montgomery County,IL,6,7,5,1,1,5,25
IL - Perry County,Perry County,IL,6,6,6,1,1,5,25
IL - Bond County,Bond County,IL,6,6,5,1,1,5,24
IL - Calhoun County,Calhoun County,IL,6,4,7,1,1,5,24
IL - Clinton County,Clinton County,IL,4,6,6,1,1,5,23
IL - De Witt County,De Witt County,IL,6,7,4,1,1,5,24
IL - Pike County,Pike County,IL,6,5,6,1,1,5,24
IL - Wabash County,Wabash County,IL,4,7,5,1,1,5,23
IL - Wayne County,Wayne County,IL,6,6,5,1,1,5,24
IL - Christian County,Christian County,IL,4,6,5,1,1,5,22
IL - Clay County,Clay County,IL,4,6,5,1,1,5,22
IL - Edgar County,Edgar County,IL,4,7,4,1,1,5,22
IL - Effingham County,Effingham County,IL,4,6,5,1,1,5,22
IL - Fayette County,Fayette County,IL,4,6,5,1,1,5,22
IL - Greene County,Greene County,IL,4,5,6,1,1,5,22
IL - Jasper County,Jasper County,IL,4,6,5,1,1,5,22
IL - Logan County,Logan County,IL,4,7,4,1,1,5,22
IL - Marion County,Marion County,IL,4,6,5,1,1,5,22
IL - Marshall County,Marshall County,IL,4,7,4,1,1,5,22
IL - Piatt County,Piatt County,IL,4,7,4,1,1,5,22
IL - Putnam County,Putnam County,IL,4,7,4,1,1,5,22
IL - Richland County,Richland County,IL,4,6,5,1,1,5,22
IL - Sangamon County,Sangamon County,IL,4,6,5,1,1,5,22
IL - Washington County,Washington County,IL,4,6,5,1,1,5,22
IL - Adams County,Adams County,IL,4,5,5,1,1,5,21
IL - Brown County,Brown County,IL,4,5,5,1,1,5,21
IL - Cass County,Cass County,IL,4,5,5,1,1,5,21
IL - Champaign County,Champaign County,IL,4,6,4,1,1,5,21
IL - Clark County,Clark County,IL,4,6,4,1,1,5,21
IL - Coles County,Coles County,IL,4,6,4,1,1,5,21
IL - Cumberland County,Cumberland County,IL,4,6,4,1,1,5,21
IL - Douglas County,Douglas County,IL,4,6,4,1,1,5,21
IL - Hancock County,Hancock County,IL,4,5,5,1,1,5,21
IL - Henderson County,Henderson County,IL,4,5,5,1,1,5,21
IL - Jefferson County,Jefferson County,IL,4,5,5,1,1,5,21
IL - Jersey County,Jersey County,IL,4,4,6,1,1,5,21
IL - Kankakee County,Kankakee County,IL,4,7,4,1,1,4,21
IL - Kendall County,Kendall County,IL,4,7,4,1,1,4,21
IL - Macoupin County,Macoupin County,IL,4,5,5,1,1,5,21
IL - Mason County,Mason County,IL,4,5,5,1,1,5,21
IL - Menard County,Menard County,IL,4,6,4,1,1,5,21
IL - Morgan County,Morgan County,IL,4,5,5,1,1,5,21
IL - Moultrie County,Moultrie County,IL,4,6,4,1,1,5,21
IL - Peoria County,Peoria County,IL,4,6,4,1,1,5,21
IL - Shelby County,Shelby County,IL,4,6,4,1,1,5,21
IL - Tazewell County,Tazewell County,IL,4,6,4,1,1,5,21
IL - Vermilion County,Vermilion County,IL,4,6,4,1,1,5,21
IL - Woodford County,Woodford County,IL,4,6,4,1,1,5,21
IL - Carroll County,Carroll County,IL,4,6,4,1,1,4,20
IL - Cook County,Cook County,IL,4,7,3,1,1,4,20
IL - Ford County,Ford County,IL,4,5,4,1,1,5,20
IL - Grundy County,Grundy County,IL,4,6,4,1,1,4,20
IL - Iroquois County,Iroquois County,IL,4,6,4,1,1,4,20
IL - LaSalle County,LaSalle County,IL,4,6,4,1,1,4,20
IL - Livingston County,Livingston County,IL,4,6,4,1,1,4,20
IL - McLean County,McLean County,IL,4,5,4,1,1,5,20
IL - Schuyler County,Schuyler County,IL,4,4,5,1,1,5,20
IL - Scott County,Scott County,IL,4,4,5,1,1,5,20
IL - Stark County,Stark County,IL,4,5,4,1,1,5,20
IL - Warren County,Warren County,IL,4,5,4,1,1,5,20
IL - Whiteside County,Whiteside County,IL,4,6,4,1,1,4,20
IL - Will County,Will County,IL,4,7,3,1,1,4,20
IL - Boone County,Boone County,IL,4,5,4,1,1,4,19
IL - Bureau County,Bureau County,IL,4,5,4,1,1,4,19
IL - DeKalb County,DeKalb County,IL,4,5,4,1,1,4,19
IL - Fulton County,Fulton County,IL,4,4,4,1,1,5,19
IL - Henry County,Henry County,IL,4,5,4,1,1,4,19
IL - Knox County,Knox County,IL,4,5,4,1,1,4,19
IL - McHenry County,McHenry County,IL,4,5,4,1,1,4,19
IL - Mercer County,Mercer County,IL,4,4,4,1,1,5,19
IL - Rock Island County,Rock Island County,IL,4,5,4,1,1,4,19
IL - Kane County,Kane County,IL,4,5,3,1,1,4,18
IL - Lake County,Lake County,IL,4,5,3,1,1,4,18
IL - McDonough County,McDonough County,IL,4,4,4,1,1,4,18
IL - Stephenson County,Stephenson County,IL,4,5,3,1,1,4,18
IL - Winnebago County,Winnebago County,IL,4,5,3,1,1,4,18
IL - DuPage County,DuPage County,IL,3,5,3,1,1,4,17
IL - Ogle County,Ogle County,IL,3,5,3,1,1,4,17
IL - Jo Daviess County,Jo Daviess County,IL,3,4,3,1,1,4,16
IL - Lee County,Lee County,IL,3,4,3,1,1,4,16
IN - Harrison County,Harrison County,IN,6,9,5,1,1,5,27
IN - Perry County,Perry County,IN,6,9,5,1,1,5,27
IN - Posey County,Posey County,IN,6,7,6,1,1,5,26
IN - Spencer County,Spencer County,IN,6,7,6,1,1,5,26
IN - Vanderburgh County,Vanderburgh County,IN,6,7,6,1,1,5,26
IN - Warrick County,Warrick County,IN,6,7,6,1,1,5,26
IN - Floyd County,Floyd County,IN,6,9,4,1,1,5,26
IN - Gibson County,Gibson County,IN,6,7,5,1,1,5,25
IN - Knox County,Knox County,IN,6,7,5,1,1,5,25
IN - Pike County,Pike County,IN,6,7,5,1,1,5,25
IN - Clark County,Clark County,IN,6,7,4,1,1,5,24
IN - Ohio County,Ohio County,IN,4,6,4,1,1,6,22
IN - Crawford County,Crawford County,IN,4,5,5,1,1,6,22
IN - Daviess County,Daviess County,IN,4,6,5,1,1,5,22
IN - Dubois County,Dubois County,IN,4,6,5,1,1,5,22
IN - Fountain County,Fountain County,IN,4,7,4,1,1,5,22
IN - Jefferson County,Jefferson County,IN,6,7,3,1,1,5,23
IN - Martin County,Martin County,IN,4,6,5,1,1,5,22
IN - Sullivan County,Sullivan County,IN,4,6,5,1,1,5,22
IN - Switzerland County,Switzerland County,IN,6,7,3,1,1,5,23
IN - Vigo County,Vigo County,IN,4,7,4,1,1,5,22
IN - Warren County,Warren County,IN,4,7,4,1,1,5,22
IN - Brown County,Brown County,IN,4,5,3,1,1,6,20
IN - Greene County,Greene County,IN,4,5,4,1,1,6,21
IN - Jasper County,Jasper County,IN,4,7,3,1,1,5,21
IN - Monroe County,Monroe County,IN,4,7,3,1,1,5,21
IN - Orange County,Orange County,IN,4,6,4,1,1,5,21
IN - Vermillion County,Vermillion County,IN,4,6,4,1,1,5,21
IN - Washington County,Washington County,IN,4,6,4,1,1,5,21
IN - Bartholomew County,Bartholomew County,IN,4,5,4,1,1,5,20
IN - Benton County,Benton County,IN,4,6,3,1,1,5,20
IN - Clay County,Clay County,IN,4,5,4,1,1,5,20
IN - Dearborn County,Dearborn County,IN,4,6,3,1,1,5,20
IN - Decatur County,Decatur County,IN,4,6,3,1,1,5,20
IN - Fayette County,Fayette County,IN,4,6,3,1,1,5,20
IN - Hendricks County,Hendricks County,IN,4,6,3,1,1,5,20
IN - Jackson County,Jackson County,IN,4,5,4,1,1,5,20
IN - Lake County,Lake County,IN,4,6,3,1,1,5,20
IN - Lawrence County,Lawrence County,IN,4,5,4,1,1,5,20
IN - Montgomery County,Montgomery County,IN,4,6,3,1,1,5,20
IN - Morgan County,Morgan County,IN,4,5,4,1,1,5,20
IN - Newton County,Newton County,IN,4,6,3,1,1,5,20
IN - Owen County,Owen County,IN,4,5,4,1,1,5,20
IN - Parke County,Parke County,IN,4,5,4,1,1,5,20
IN - Porter County,Porter County,IN,4,6,3,1,1,5,20
IN - Ripley County,Ripley County,IN,4,6,3,1,1,5,20
IN - Tippecanoe County,Tippecanoe County,IN,4,6,3,1,1,5,20
IN - Adams County,Adams County,IN,4,5,3,1,1,5,19
IN - Boone County,Boone County,IN,4,5,3,1,1,5,19
IN - Carroll County,Carroll County,IN,4,5,3,1,1,5,19
IN - Cass County,Cass County,IN,4,5,3,1,1,5,19
IN - Clinton County,Clinton County,IN,4,5,3,1,1,5,19
IN - Franklin County,Franklin County,IN,4,5,3,1,1,5,19
IN - Grant County,Grant County,IN,4,5,3,1,1,5,19
IN - Hamilton County,Hamilton County,IN,4,5,3,1,1,5,19
IN - Hancock County,Hancock County,IN,4,5,3,1,1,5,19
IN - Howard County,Howard County,IN,4,5,3,1,1,5,19
IN - Huntington County,Huntington County,IN,4,5,3,1,1,5,19
IN - Jennings County,Jennings County,IN,4,5,3,1,1,5,19
IN - Johnson County,Johnson County,IN,4,5,3,1,1,5,19
IN - LaPorte County,LaPorte County,IN,3,6,3,1,1,5,19
IN - Madison County,Madison County,IN,4,5,3,1,1,5,19
IN - Marion County,Marion County,IN,4,5,3,1,1,5,19
IN - Miami County,Miami County,IN,4,5,3,1,1,5,19
IN - Putnam County,Putnam County,IN,4,4,4,1,1,5,19
IN - Rush County,Rush County,IN,4,5,3,1,1,5,19
IN - Scott County,Scott County,IN,4,5,3,1,1,5,19
IN - Shelby County,Shelby County,IN,4,5,3,1,1,5,19
IN - Starke County,Starke County,IN,3,6,3,1,1,5,19
IN - Tipton County,Tipton County,IN,4,5,3,1,1,5,19
IN - Union County,Union County,IN,4,5,3,1,1,5,19
IN - Wabash County,Wabash County,IN,4,5,3,1,1,5,19
IN - Wells County,Wells County,IN,4,5,3,1,1,5,19
IN - White County,White County,IN,4,5,3,1,1,5,19
IN - Allen County,Allen County,IN,4,4,3,1,1,5,18
IN - Blackford County,Blackford County,IN,4,4,3,1,1,5,18
IN - Delaware County,Delaware County,IN,4,4,3,1,1,5,18
IN - Elkhart County,Elkhart County,IN,3,5,3,1,1,5,18
IN - Fulton County,Fulton County,IN,3,5,3,1,1,5,18
IN - Jay County,Jay County,IN,4,4,3,1,1,5,18
IN - LaGrange County,LaGrange County,IN,4,4,3,1,1,5,18
IN - Marshall County,Marshall County,IN,3,5,3,1,1,5,18
IN - Pulaski County,Pulaski County,IN,3,5,3,1,1,5,18
IN - St. Joseph County,St. Joseph County,IN,3,5,3,1,1,5,18
IN - DeKalb County,DeKalb County,IN,3,4,3,1,1,5,17
IN - Kosciusko County,Kosciusko County,IN,3,4,3,1,1,5,17
IN - Noble County,Noble County,IN,3,4,3,1,1,5,17
IN - Steuben County,Steuben County,IN,3,4,3,1,1,5,17
IN - Wayne County,Wayne County,IN,4,2,3,1,1,5,16
IN - Whitley County,Whitley County,IN,3,4,3,1,1,5,17
IN - Henry County,Henry County,IN,3,2,3,1,1,5,15
IN - Randolph County,Randolph County,IN,3,2,3,1,1,5,15
KS - Barber County,Barber County,KS,9,4,9,1,1,5,29
KS - Clark County,Clark County,KS,9,2,8,1,2,5,27
KS - Comanche County,Comanche County,KS,7,4,9,1,1,5,27
KS - Barton County,Barton County,KS,7,4,8,1,1,5,26
KS - Bourbon County,Bourbon County,KS,6,4,8,1,2,5,26
KS - Chautauqua County,Chautauqua County,KS,7,2,8,1,2,5,25
KS - Dickinson County,Dickinson County,KS,7,4,8,1,1,5,26
KS - Ellis County,Ellis County,KS,7,2,8,1,2,5,25
KS - Graham County,Graham County,KS,7,2,8,1,2,5,25
KS - Greenwood County,Greenwood County,KS,6,2,8,1,3,5,25
KS - Harper County,Harper County,KS,7,2,9,1,1,5,25
KS - Hodgeman County,Hodgeman County,KS,7,2,8,1,2,5,25
KS - Kiowa County,Kiowa County,KS,7,4,8,1,1,5,26
KS - Lyon County,Lyon County,KS,6,2,8,1,3,5,25
KS - Ness County,Ness County,KS,7,2,8,1,2,5,25
KS - Osborne County,Osborne County,KS,7,2,8,1,2,5,25
KS - Ottawa County,Ottawa County,KS,7,4,8,1,1,5,26
KS - Pawnee County,Pawnee County,KS,7,4,8,1,1,5,26
KS - Phillips County,Phillips County,KS,7,2,8,1,2,5,25
KS - Rooks County,Rooks County,KS,7,2,8,1,2,5,25
KS - Rush County,Rush County,KS,7,2,8,1,2,5,25
KS - Saline County,Saline County,KS,7,4,8,1,1,5,26
KS - Sedgwick County,Sedgwick County,KS,7,4,8,1,1,5,26
KS - Stafford County,Stafford County,KS,7,4,8,1,1,5,26
KS - Trego County,Trego County,KS,7,2,8,1,2,5,25
KS - Wyandotte County,Wyandotte County,KS,6,4,8,1,2,5,26
KS - Anderson County,Anderson County,KS,6,4,8,1,1,5,25
KS - Chase County,Chase County,KS,6,2,8,1,2,5,24
KS - Coffey County,Coffey County,KS,6,2,8,1,2,5,24
KS - Crawford County,Crawford County,KS,6,4,8,1,1,5,25
KS - Elk County,Elk County,KS,6,2,8,1,2,5,24
KS - Ford County,Ford County,KS,7,2,8,1,2,5,25
KS - Geary County,Geary County,KS,6,2,8,1,2,5,24
KS - Kingman County,Kingman County,KS,7,2,8,1,1,5,24
KS - Lincoln County,Lincoln County,KS,7,2,8,1,1,5,24
KS - Linn County,Linn County,KS,6,2,8,1,2,5,24
KS - Miami County,Miami County,KS,6,2,8,1,2,5,24
KS - Mitchell County,Mitchell County,KS,7,2,8,1,1,5,24
KS - Montgomery County,Montgomery County,KS,6,2,8,1,2,5,24
KS - Morris County,Morris County,KS,6,2,8,1,2,5,24
KS - Norton County,Norton County,KS,7,2,8,1,2,5,25
KS - Osage County,Osage County,KS,6,2,8,1,2,6,25
KS - Pottawatomie County,Pottawatomie County,KS,6,2,8,1,2,5,24
KS - Pratt County,Pratt County,KS,7,4,8,1,1,5,26
KS - Reno County,Reno County,KS,7,2,8,1,1,5,24
KS - Rice County,Rice County,KS,7,2,8,1,1,5,24
KS - Russell County,Russell County,KS,7,2,8,1,1,5,24
KS - Smith County,Smith County,KS,7,2,8,1,1,5,24
KS - Sumner County,Sumner County,KS,7,2,8,1,1,5,24
KS - Wabaunsee County,Wabaunsee County,KS,6,2,8,1,2,5,24
KS - Wilson County,Wilson County,KS,6,2,8,1,2,5,24
KS - Woodson County,Woodson County,KS,6,2,8,1,2,5,24
KS - Allen County,Allen County,KS,6,2,8,1,1,5,23
KS - Butler County,Butler County,KS,6,2,8,1,1,5,23
KS - Cherokee County,Cherokee County,KS,6,2,8,1,1,5,23
KS - Clay County,Clay County,KS,6,2,8,1,1,5,23
KS - Cloud County,Cloud County,KS,6,2,8,1,1,5,23
KS - Cowley County,Cowley County,KS,6,2,8,1,1,5,23
KS - Douglas County,Douglas County,KS,6,2,8,1,1,5,23
KS - Edwards County,Edwards County,KS,7,4,7,1,1,5,25
KS - Ellsworth County,Ellsworth County,KS,6,2,8,1,1,5,23
KS - Grant County,Grant County,KS,7,2,8,1,1,5,24
KS - Hamilton County,Hamilton County,KS,7,2,7,1,2,5,24
KS - Labette County,Labette County,KS,6,2,8,1,1,5,23
KS - McPherson County,McPherson County,KS,6,2,8,1,1,5,23
KS - Marion County,Marion County,KS,6,2,8,1,1,5,23
KS - Meade County,Meade County,KS,7,2,7,1,2,5,24
KS - Morton County,Morton County,KS,7,2,8,1,1,5,24
KS - Neosho County,Neosho County,KS,6,2,8,1,1,5,23
KS - Riley County,Riley County,KS,6,2,8,1,1,5,23
KS - Scott County,Scott County,KS,7,2,8,1,1,5,24
KS - Seward County,Seward County,KS,7,2,8,1,1,5,24
KS - Stanton County,Stanton County,KS,7,2,8,1,1,5,24
KS - Finney County,Finney County,KS,7,2,7,1,1,5,23
KS - Franklin County,Franklin County,KS,6,2,8,1,1,5,23
KS - Gove County,Gove County,KS,6,2,7,1,2,5,23
KS - Gray County,Gray County,KS,7,2,7,1,1,5,23
KS - Greeley County,Greeley County,KS,7,2,6,1,2,5,23
KS - Harvey County,Harvey County,KS,6,2,8,1,1,5,23
KS - Haskell County,Haskell County,KS,7,2,7,1,1,5,23
KS - Jackson County,Jackson County,KS,6,2,8,1,1,5,23
KS - Jefferson County,Jefferson County,KS,4,2,8,1,1,6,22
KS - Jewell County,Jewell County,KS,6,2,8,1,1,5,23
KS - Johnson County,Johnson County,KS,4,2,8,1,2,5,22
KS - Kearny County,Kearny County,KS,7,2,7,1,1,5,23
KS - Lane County,Lane County,KS,7,2,7,1,1,5,23
KS - Leavenworth County,Leavenworth County,KS,4,2,8,1,1,5,21
KS - Logan County,Logan County,KS,6,2,7,1,2,5,23
KS - Marshall County,Marshall County,KS,6,2,8,1,1,5,23
KS - Republic County,Republic County,KS,6,2,8,1,1,5,23
KS - Shawnee County,Shawnee County,KS,6,2,8,1,1,5,23
KS - Stevens County,Stevens County,KS,7,2,7,1,1,5,23
KS - Washington County,Washington County,KS,6,2,8,1,1,5,23
KS - Wichita County,Wichita County,KS,7,2,7,1,1,5,23
KS - Decatur County,Decatur County,KS,6,2,6,1,2,5,22
KS - Nemaha County,Nemaha County,KS,6,2,7,1,1,5,22
KS - Rawlins County,Rawlins County,KS,7,2,5,1,2,5,22
KS - Thomas County,Thomas County,KS,7,2,5,1,2,5,22
KS - Wallace County,Wallace County,KS,6,2,6,1,2,5,22
KS - Atchison County,Atchison County,KS,4,2,7,1,1,5,20
KS - Brown County,Brown County,KS,6,2,6,1,1,5,21
KS - Cheyenne County,Cheyenne County,KS,7,2,5,1,1,5,21
KS - Sheridan County,Sheridan County,KS,6,2,5,1,2,5,21
KS - Doniphan County,Doniphan County,KS,4,2,6,1,1,5,19
KS - Sherman County,Sherman County,KS,6,1,5,1,2,5,20
KY - Ballard County,Ballard County,KY,6,7,8,1,1,5,28
KY - McCracken County,McCracken County,KY,6,7,8,1,1,5,28
KY - Carlisle County,Carlisle County,KY,6,7,8,1,1,5,28
KY - Fulton County,Fulton County,KY,6,6,8,1,1,5,27
KY - Graves County,Graves County,KY,6,7,8,1,1,5,28
KY - Livingston County,Livingston County,KY,6,7,8,1,1,5,28
KY - Marshall County,Marshall County,KY,6,7,8,1,1,5,28
KY - Christian County,Christian County,KY,6,7,7,1,1,5,27
KY - Crittenden County,Crittenden County,KY,6,7,7,1,1,5,27
KY - Hickman County,Hickman County,KY,6,6,8,1,1,5,27
KY - Lyon County,Lyon County,KY,6,7,7,1,1,5,27
KY - McLean County,McLean County,KY,6,7,7,1,1,5,27
KY - Muhlenberg County,Muhlenberg County,KY,6,7,7,1,1,5,27
KY - Todd County,Todd County,KY,6,7,7,1,1,5,27
KY - Trigg County,Trigg County,KY,6,7,7,1,1,5,27
KY - Webster County,Webster County,KY,6,7,7,1,1,5,27
KY - Butler County,Butler County,KY,6,7,6,1,1,5,26
KY - Caldwell County,Caldwell County,KY,6,7,6,1,1,5,26
KY - Calloway County,Calloway County,KY,6,6,7,1,1,5,26
KY - Daviess County,Daviess County,KY,6,7,6,1,1,5,26
KY - Hancock County,Hancock County,KY,6,9,5,1,1,5,27
KY - Henderson County,Henderson County,KY,6,7,6,1,1,5,26
KY - Ohio County,Ohio County,KY,6,6,7,1,1,5,26
KY - Union County,Union County,KY,6,7,6,1,1,5,26
KY - Warren County,Warren County,KY,6,7,6,1,1,5,26
KY - Barren County,Barren County,KY,7,7,4,1,1,5,25
KY - Bullitt County,Bullitt County,KY,6,9,4,1,1,5,26
KY - Edmonson County,Edmonson County,KY,7,7,4,1,1,5,25
KY - Elliott County,Elliott County,KY,6,6,5,1,2,5,25
KY - Hopkins County,Hopkins County,KY,6,5,7,1,1,5,25
KY - Jefferson County,Jefferson County,KY,6,9,4,1,1,5,26
KY - Logan County,Logan County,KY,6,6,6,1,1,5,25
KY - Simpson County,Simpson County,KY,6,6,5,1,1,5,24
KY - Spencer County,Spencer County,KY,6,9,3,1,1,5,25
KY - Adair County,Adair County,KY,6,6,4,1,1,5,23
KY - Breckinridge County,Breckinridge County,KY,6,6,4,1,1,5,23
KY - Carroll County,Carroll County,KY,6,7,3,1,1,5,23
KY - Green County,Green County,KY,6,6,4,1,1,5,23
KY - Meade County,Meade County,KY,6,6,4,1,1,5,23
KY - Menifee County,Menifee County,KY,6,6,3,1,2,5,23
KY - Metcalfe County,Metcalfe County,KY,6,6,4,1,1,5,23
KY - Monroe County,Monroe County,KY,6,6,4,1,1,5,23
KY - Montgomery County,Montgomery County,KY,6,5,4,1,2,5,23
KY - Powell County,Powell County,KY,6,6,3,1,2,5,23
KY - Rowan County,Rowan County,KY,6,6,3,1,2,5,23
KY - Shelby County,Shelby County,KY,6,7,3,1,1,5,23
KY - Taylor County,Taylor County,KY,6,6,4,1,1,5,23
KY - Bath County,Bath County,KY,6,5,3,1,2,5,22
KY - Henry County,Henry County,KY,6,6,3,1,1,5,22
KY - Kenton County,Kenton County,KY,4,5,5,1,1,5,21
KY - Marion County,Marion County,KY,6,5,4,1,1,5,22
KY - Nelson County,Nelson County,KY,4,5,5,1,1,5,21
KY - Oldham County,Oldham County,KY,6,6,3,1,1,5,22
KY - Trimble County,Trimble County,KY,6,6,3,1,1,5,22
KY - Washington County,Washington County,KY,6,5,4,1,1,5,22
KY - Allen County,Allen County,KY,4,4,5,1,1,5,20
KY - Anderson County,Anderson County,KY,4,5,4,1,1,5,20
KY - Boyle County,Boyle County,KY,6,5,3,1,1,5,21
KY - Campbell County,Campbell County,KY,4,5,4,1,1,5,20
KY - Casey County,Casey County,KY,6,5,3,1,1,5,21
KY - Clay County,Clay County,KY,4,4,4,1,2,5,20
KY - Fleming County,Fleming County,KY,6,5,3,1,1,5,21
KY - Franklin County,Franklin County,KY,4,5,4,1,1,5,20
KY - Gallatin County,Gallatin County,KY,4,6,3,1,1,5,20
KY - Hardin County,Hardin County,KY,4,5,4,1,1,5,20
KY - Hart County,Hart County,KY,4,5,4,1,1,5,20
KY - Jackson County,Jackson County,KY,4,4,4,1,2,5,20
KY - Larue County,Larue County,KY,4,5,4,1,1,5,20
KY - Laurel County,Laurel County,KY,4,4,4,1,2,5,20
KY - Lewis County,Lewis County,KY,6,5,3,1,1,5,21
KY - Madison County,Madison County,KY,4,4,4,1,2,5,20
KY - Mercer County,Mercer County,KY,4,5,4,1,1,5,20
KY - Pulaski County,Pulaski County,KY,4,5,3,1,2,5,20
KY - Rockcastle County,Rockcastle County,KY,4,4,4,1,2,5,20
KY - Whitley County,Whitley County,KY,4,2,5,1,2,5,19
KY - Boone County,Boone County,KY,4,5,3,1,1,5,19
KY - Carter County,Carter County,KY,3,4,4,1,2,5,19
KY - Clark County,Clark County,KY,4,5,3,1,1,5,19
KY - Cumberland County,Cumberland County,KY,4,4,4,1,1,5,19
KY - Estill County,Estill County,KY,4,4,3,1,2,5,19
KY - Fayette County,Fayette County,KY,4,5,3,1,1,5,19
KY - Floyd County,Floyd County,KY,3,4,4,1,2,5,19
KY - Garrard County,Garrard County,KY,4,4,4,1,1,5,19
KY - Grant County,Grant County,KY,4,5,3,1,1,5,19
KY - Grayson County,Grayson County,KY,4,4,4,1,1,5,19
KY - Greenup County,Greenup County,KY,4,4,3,1,2,5,19
KY - Harrison County,Harrison County,KY,4,4,4,1,1,5,19
KY - Jessamine County,Jessamine County,KY,4,5,3,1,1,5,19
KY - Johnson County,Johnson County,KY,3,4,4,1,2,5,19
KY - Knox County,Knox County,KY,4,4,3,1,2,5,19
KY - Lawrence County,Lawrence County,KY,4,4,3,1,2,5,19
KY - Nicholas County,Nicholas County,KY,4,4,4,1,1,5,19
KY - Owen County,Owen County,KY,4,5,3,1,1,5,19
KY - Owsley County,Owsley County,KY,3,4,4,1,2,5,19
KY - Pendleton County,Pendleton County,KY,4,5,3,1,1,5,19
KY - Robertson County,Robertson County,KY,4,4,4,1,1,5,19
KY - Russell County,Russell County,KY,4,4,3,1,2,5,19
KY - Scott County,Scott County,KY,4,5,3,1,1,5,19
KY - Wayne County,Wayne County,KY,4,4,3,1,2,5,19
KY - Wolfe County,Wolfe County,KY,3,4,4,1,2,5,19
KY - Woodford County,Woodford County,KY,4,5,3,1,1,5,19
KY - Bourbon County,Bourbon County,KY,4,4,3,1,1,5,18
KY - Bracken County,Bracken County,KY,4,4,3,1,1,5,18
KY - Breathitt County,Breathitt County,KY,3,2,4,1,2,5,17
KY - Clinton County,Clinton County,KY,4,4,3,1,1,5,18
KY - Lee County,Lee County,KY,3,4,3,1,2,5,18
KY - Lincoln County,Lincoln County,KY,4,4,3,1,1,5,18
KY - McCreary County,McCreary County,KY,4,2,3,1,2,5,17
KY - Magoffin County,Magoffin County,KY,3,2,4,1,2,5,17
KY - Mason County,Mason County,KY,4,5,3,1,1,4,18
KY - Morgan County,Morgan County,KY,3,4,3,1,2,5,18
KY - Perry County,Perry County,KY,3,2,4,1,2,5,17
KY - Bell County,Bell County,KY,4,2,3,1,2,4,16
KY - Boyd County,Boyd County,KY,3,4,3,1,2,4,17
KY - Leslie County,Leslie County,KY,4,4,1,1,2,5,17
KY - Pike County,Pike County,KY,3,1,3,1,2,5,15
KY - Martin County,Martin County,KY,4,4,1,1,2,4,16
KY - Harlan County,Harlan County,KY,4,1,1,1,2,5,14
KY - Knott County,Knott County,KY,3,2,1,1,2,5,14
KY - Letcher County,Letcher County,KY,3,1,1,1,2,4,12
LA - St. Martin Parish,St. Martin Parish,LA,7,10,8,4,3,7,39
LA - Assumption Parish,Assumption Parish,LA,6,9,7,7,2,9,40
LA - Jefferson Davis Parish,Jefferson Davis Parish,LA,7,10,8,4,1,8,38
LA - Livingston Parish,Livingston Parish,LA,7,9,8,6,1,8,39
LA - St. John the Baptist Parish,St. John the Baptist Parish,LA,6,9,8,6,2,8,39
LA - Calcasieu Parish,Calcasieu Parish,LA,6,10,8,4,1,8,37
LA - Lafayette Parish,Lafayette Parish,LA,7,10,8,3,2,7,37
LA - St. James Parish,St. James Parish,LA,6,10,8,6,2,6,38
LA - St. Landry Parish,St. Landry Parish,LA,7,9,8,3,3,7,37
LA - Beauregard Parish,Beauregard Parish,LA,7,10,9,1,1,7,35
LA - Lafourche Parish,Lafourche Parish,LA,4,9,8,6,2,7,36
LA - East Baton Rouge Parish,East Baton Rouge Parish,LA,7,10,9,3,2,5,36
LA - Iberville Parish,Iberville Parish,LA,7,9,8,4,2,6,36
LA - Pointe Coupee Parish,Pointe Coupee Parish,LA,7,10,8,1,3,6,35
LA - Tangipahoa Parish,Tangipahoa Parish,LA,7,7,8,4,1,7,34
LA - Acadia Parish,Acadia Parish,LA,6,7,8,4,1,7,33
LA - Ascension Parish,Ascension Parish,LA,6,9,8,4,2,6,35
LA - Cameron Parish,Cameron Parish,LA,6,10,3,10,1,8,38
LA - Evangeline Parish,Evangeline Parish,LA,7,7,8,1,1,7,31
LA - West Baton Rouge Parish,West Baton Rouge Parish,LA,7,10,8,1,2,5,33
LA - Allen Parish,Allen Parish,LA,7,6,8,1,1,7,30
LA - St. Mary Parish,St. Mary Parish,LA,4,9,3,7,2,8,33
LA - Vermilion Parish,Vermilion Parish,LA,6,9,3,6,1,9,34
LA - Iberia Parish,Iberia Parish,LA,6,9,3,4,2,8,32
LA - Vernon Parish,Vernon Parish,LA,7,4,10,1,1,6,29
LA - Avoyelles Parish,Avoyelles Parish,LA,7,4,8,1,3,6,29
LA - East Feliciana Parish,East Feliciana Parish,LA,6,5,8,1,1,7,28
LA - Rapides Parish,Rapides Parish,LA,7,7,8,1,1,5,29
LA - Terrebonne Parish,Terrebonne Parish,LA,4,9,1,7,3,8,32
LA - Bossier Parish,Bossier Parish,LA,9,4,9,1,1,5,29
LA - De Soto Parish,De Soto Parish,LA,9,4,9,1,1,5,29
LA - Ouachita Parish,Ouachita Parish,LA,9,5,8,1,1,5,29
LA - Washington Parish,Washington Parish,LA,7,6,8,1,1,6,29
LA - Bienville Parish,Bienville Parish,LA,7,2,10,1,1,5,26
LA - Caddo Parish,Caddo Parish,LA,9,4,8,1,1,5,28
LA - Caldwell Parish,Caldwell Parish,LA,9,2,9,1,1,5,27
LA - Natchitoches Parish,Natchitoches Parish,LA,9,4,8,1,1,5,28
LA - Union Parish,Union Parish,LA,7,4,9,1,1,5,27
LA - West Feliciana Parish,West Feliciana Parish,LA,7,2,9,1,1,6,26
LA - Catahoula Parish,Catahoula Parish,LA,9,2,8,1,1,6,27
LA - Claiborne Parish,Claiborne Parish,LA,7,2,9,1,1,5,25
LA - Grant Parish,Grant Parish,LA,7,2,9,1,1,5,25
LA - Lincoln Parish,Lincoln Parish,LA,7,2,9,1,1,5,25
LA - Richland Parish,Richland Parish,LA,9,4,8,1,1,5,28
LA - St. Bernard Parish,St. Bernard Parish,LA,4,6,1,7,2,8,28
LA - St. Charles Parish,St. Charles Parish,LA,6,10,1,7,2,5,31
LA - Franklin Parish,Franklin Parish,LA,9,2,8,1,1,5,26
LA - Jefferson Parish,Jefferson Parish,LA,6,7,1,4,2,7,27
LA - LaSalle Parish,LaSalle Parish,LA,7,2,8,1,1,5,24
LA - Red River Parish,Red River Parish,LA,7,2,8,1,1,5,24
LA - Tensas Parish,Tensas Parish,LA,9,2,7,1,1,6,26
LA - East Carroll Parish,East Carroll Parish,LA,7,5,6,1,1,5,25
LA - Madison Parish,Madison Parish,LA,7,4,7,1,1,5,25
LA - Orleans Parish,Orleans Parish,LA,6,7,1,4,2,6,26
LA - West Carroll Parish,West Carroll Parish,LA,7,4,7,1,1,5,25
LA - Concordia Parish,Concordia Parish,LA,7,2,7,1,1,5,23
LA - Morehouse Parish,Morehouse Parish,LA,7,2,7,1,1,5,23
LA - St. Helena Parish,St. Helena Parish,LA,7,6,1,1,1,8,24
LA - St. Tammany Parish,St. Tammany Parish,LA,6,5,1,4,2,7,25
LA - Plaquemines Parish,Plaquemines Parish,LA,6,7,1,6,1,5,26
LA - Sabine Parish,Sabine Parish,LA,9,4,1,1,1,5,21
LA - Winn Parish,Winn Parish,LA,9,4,1,1,1,5,21
LA - Webster Parish,Webster Parish,LA,7,4,1,1,1,5,19
LA - Jackson Parish,Jackson Parish,LA,7,2,1,1,1,5,17
MA - Suffolk County,Suffolk County,MA,3,4,1,6,1,5,20
MA - Barnstable County,Barnstable County,MA,3,2,1,7,1,4,18
MA - Dukes County,Dukes County,MA,3,4,1,4,1,5,18
MA - Essex County,Essex County,MA,3,5,1,4,1,4,18
MA - Nantucket County,Nantucket County,MA,3,2,1,4,1,6,17
MA - Hampden County,Hampden County,MA,4,5,1,1,1,4,16
MA - Middlesex County,Middlesex County,MA,3,4,1,4,1,4,17
MA - Norfolk County,Norfolk County,MA,3,4,1,4,1,4,17
MA - Bristol County,Bristol County,MA,3,2,1,4,1,4,15
MA - Plymouth County,Plymouth County,MA,3,2,1,4,1,4,15
MA - Franklin County,Franklin County,MA,3,4,1,1,1,4,14
MA - Hampshire County,Hampshire County,MA,3,4,1,1,1,4,14
MA - Worcester County,Worcester County,MA,3,4,1,1,1,4,14
MA - Berkshire County,Berkshire County,MA,3,2,1,1,1,4,12
MD - Worcester County,Worcester County,MD,4,5,4,6,2,6,27
MD - Somerset County,Somerset County,MD,4,5,4,7,1,6,27
MD - Dorchester County,Dorchester County,MD,4,5,4,7,1,5,26
MD - Talbot County,Talbot County,MD,4,5,4,4,1,5,23
MD - Caroline County,Caroline County,MD,4,4,5,4,1,4,22
MD - Kent County,Kent County,MD,4,4,5,4,1,4,22
MD - Queen Anne's County,Queen Anne's County,MD,4,4,5,4,1,4,22
MD - Anne Arundel County,Anne Arundel County,MD,4,4,5,3,1,4,21
MD - Charles County,Charles County,MD,4,4,4,4,1,4,21
MD - Prince George's County,Prince George's County,MD,6,2,5,3,1,4,21
MD - Wicomico County,Wicomico County,MD,4,4,4,4,1,4,21
MD - Montgomery County,Montgomery County,MD,4,4,5,1,1,4,19
MD - St. Mary's County,St. Mary's County,MD,4,4,3,4,1,4,20
MD - Allegany County,Allegany County,MD,6,2,3,1,2,4,18
MD - Calvert County,Calvert County,MD,4,1,4,4,1,4,18
MD - Cecil County,Cecil County,MD,4,1,4,4,1,4,18
MD - Baltimore County,Baltimore County,MD,4,1,4,3,1,4,17
MD - Harford County,Harford County,MD,4,1,4,3,1,4,17
MD - Washington County,Washington County,MD,4,2,3,1,2,4,16
MD - Frederick County,Frederick County,MD,3,2,4,1,1,4,15
MD - Garrett County,Garrett County,MD,3,2,3,1,2,4,15
MD - Howard County,Howard County,MD,4,1,4,1,1,4,15
MD - Carroll County,Carroll County,MD,3,1,3,1,1,4,13
MD - Baltimore city,Baltimore city,MD,4,1,1,3,1,4,14
ME - Hancock County,Hancock County,ME,3,4,1,3,1,6,18
ME - Cumberland County,Cumberland County,ME,3,4,1,4,1,4,17
ME - Sagadahoc County,Sagadahoc County,ME,3,5,1,4,1,3,17
ME - York County,York County,ME,3,4,1,4,1,4,17
ME - Knox County,Knox County,ME,3,4,1,3,1,4,16
ME - Androscoggin County,Androscoggin County,ME,3,4,1,1,1,4,14
ME - Kennebec County,Kennebec County,ME,3,4,1,1,1,4,14
ME - Penobscot County,Penobscot County,ME,3,4,1,3,1,3,15
ME - Washington County,Washington County,ME,3,4,1,4,1,2,15
ME - Lincoln County,Lincoln County,ME,3,2,1,4,1,2,13
ME - Waldo County,Waldo County,ME,3,2,1,3,1,3,13
ME - Oxford County,Oxford County,ME,3,4,1,1,1,2,12
ME - Somerset County,Somerset County,ME,3,2,1,1,1,3,11
ME - Aroostook County,Aroostook County,ME,3,2,1,1,1,2,10
ME - Franklin County,Franklin County,ME,3,2,1,1,1,2,10
ME - Piscataquis County,Piscataquis County,ME,3,2,1,1,1,1,9
MI - Berrien County,Berrien County,MI,4,5,3,1,1,4,18
MI - Mackinac County,Mackinac County,MI,3,4,3,1,3,4,18
MI - St. Joseph County,St. Joseph County,MI,4,5,3,1,1,4,18
MI - Baraga County,Baraga County,MI,3,2,3,1,3,4,16
MI - Bay County,Bay County,MI,3,5,3,1,1,4,17
MI - Cheboygan County,Cheboygan County,MI,3,4,3,1,2,4,17
MI - Gogebic County,Gogebic County,MI,3,4,3,1,2,4,17
MI - Hillsdale County,Hillsdale County,MI,4,4,3,1,1,4,17
MI - Monroe County,Monroe County,MI,3,5,3,1,1,4,17
MI - Oakland County,Oakland County,MI,4,4,3,1,1,4,17
MI - Oscoda County,Oscoda County,MI,3,4,3,1,2,4,17
MI - Otsego County,Otsego County,MI,3,4,3,1,2,4,17
MI - Ottawa County,Ottawa County,MI,3,5,3,1,1,4,17
MI - Van Buren County,Van Buren County,MI,3,5,3,1,1,4,17
MI - Wayne County,Wayne County,MI,4,4,3,1,1,4,17
MI - Alcona County,Alcona County,MI,3,4,3,1,1,4,16
MI - Alpena County,Alpena County,MI,3,4,3,1,1,4,16
MI - Barry County,Barry County,MI,3,4,3,1,1,4,16
MI - Branch County,Branch County,MI,3,4,3,1,1,4,16
MI - Calhoun County,Calhoun County,MI,3,4,3,1,1,4,16
MI - Cass County,Cass County,MI,3,4,3,1,1,4,16
MI - Chippewa County,Chippewa County,MI,3,4,3,1,1,4,16
MI - Clinton County,Clinton County,MI,3,4,3,1,1,4,16
MI - Eaton County,Eaton County,MI,3,4,3,1,1,4,16
MI - Emmet County,Emmet County,MI,3,2,3,1,2,4,15
MI - Genesee County,Genesee County,MI,3,4,3,1,1,4,16
MI - Gladwin County,Gladwin County,MI,3,4,3,1,1,4,16
MI - Gratiot County,Gratiot County,MI,3,4,3,1,1,4,16
MI - Houghton County,Houghton County,MI,3,2,3,1,3,3,15
MI - Huron County,Huron County,MI,3,4,3,1,1,4,16
MI - Ingham County,Ingham County,MI,3,4,3,1,1,4,16
MI - Jackson County,Jackson County,MI,3,4,3,1,1,4,16
MI - Kalamazoo County,Kalamazoo County,MI,3,4,3,1,1,4,16
MI - Kalkaska County,Kalkaska County,MI,3,2,3,1,2,4,15
MI - Lapeer County,Lapeer County,MI,3,4,3,1,1,4,16
MI - Lenawee County,Lenawee County,MI,3,4,3,1,1,4,16
MI - Livingston County,Livingston County,MI,3,4,3,1,1,4,16
MI - Marquette County,Marquette County,MI,3,1,3,1,3,4,15
MI - Midland County,Midland County,MI,3,4,3,1,1,4,16
MI - Missaukee County,Missaukee County,MI,3,2,3,1,2,4,15
MI - Montmorency County,Montmorency County,MI,3,2,3,1,2,4,15
MI - Ogemaw County,Ogemaw County,MI,3,2,3,1,2,4,15
MI - Ontonagon County,Ontonagon County,MI,3,5,3,1,1,3,16
MI - Roscommon County,Roscommon County,MI,3,2,3,1,2,4,15
MI - Saginaw County,Saginaw County,MI,3,4,3,1,1,4,16
MI - Sanilac County,Sanilac County,MI,3,4,3,1,1,4,16
MI - Shiawassee County,Shiawassee County,MI,3,4,3,1,1,4,16
MI - Tuscola County,Tuscola County,MI,3,4,3,1,1,4,16
MI - Washtenaw County,Washtenaw County,MI,3,4,3,1,1,4,16
MI - Allegan County,Allegan County,MI,3,2,3,1,1,4,14
MI - Clare County,Clare County,MI,3,2,3,1,1,4,14
MI - Dickinson County,Dickinson County,MI,3,1,3,1,2,4,14
MI - Ionia County,Ionia County,MI,3,2,3,1,1,4,14
MI - Iosco County,Iosco County,MI,3,2,3,1,1,4,14
MI - Isabella County,Isabella County,MI,3,2,3,1,1,4,14
MI - Kent County,Kent County,MI,3,2,3,1,1,4,14
MI - Macomb County,Macomb County,MI,3,2,3,1,1,4,14
MI - Mason County,Mason County,MI,3,2,3,1,1,4,14
MI - Menominee County,Menominee County,MI,3,1,3,1,2,4,14
MI - Montcalm County,Montcalm County,MI,3,2,3,1,1,4,14
MI - Muskegon County,Muskegon County,MI,3,2,3,1,1,4,14
MI - Newaygo County,Newaygo County,MI,3,2,3,1,1,4,14
MI - Presque Isle County,Presque Isle County,MI,3,2,3,1,1,4,14
MI - St. Clair County,St. Clair County,MI,3,2,3,1,1,4,14
MI - Schoolcraft County,Schoolcraft County,MI,3,1,3,1,2,4,14
MI - Wexford County,Wexford County,MI,3,1,3,1,2,4,14
MI - Antrim County,Antrim County,MI,3,1,3,1,1,4,13
MI - Arenac County,Arenac County,MI,3,1,3,1,1,4,13
MI - Benzie County,Benzie County,MI,3,1,3,1,1,4,13
MI - Charlevoix County,Charlevoix County,MI,3,1,3,1,1,4,13
MI - Delta County,Delta County,MI,3,1,3,1,1,4,13
MI - Grand Traverse County,Grand Traverse County,MI,3,1,3,1,1,4,13
MI - Iron County,Iron County,MI,3,2,1,1,3,4,14
MI - Lake County,Lake County,MI,3,1,3,1,1,4,13
MI - Leelanau County,Leelanau County,MI,3,1,3,1,1,4,13
MI - Manistee County,Manistee County,MI,3,1,3,1,1,4,13
MI - Mecosta County,Mecosta County,MI,3,1,3,1,1,4,13
MI - Oceana County,Oceana County,MI,3,1,3,1,1,4,13
MI - Osceola County,Osceola County,MI,3,1,3,1,1,4,13
MI - Alger County,Alger County,MI,3,1,3,1,1,3,12
MI - Crawford County,Crawford County,MI,3,2,1,1,2,4,13
MI - Luce County,Luce County,MI,3,2,1,1,1,4,12
MI - Keweenaw County,Keweenaw County,MI,3,5,1,1,1,1,12
MN - St. Louis County,St. Louis County,MN,3,1,3,1,7,4,19
MN - Aitkin County,Aitkin County,MN,3,2,3,1,6,4,19
MN - Beltrami County,Beltrami County,MN,3,1,3,1,6,4,18
MN - Cass County,Cass County,MN,3,2,3,1,6,4,19
MN - Itasca County,Itasca County,MN,3,1,3,1,6,4,18
MN - Koochiching County,Koochiching County,MN,3,1,3,1,6,4,18
MN - Clearwater County,Clearwater County,MN,3,1,3,1,6,4,18
MN - Crow Wing County,Crow Wing County,MN,3,2,3,1,5,4,18
MN - Morrison County,Morrison County,MN,4,4,3,1,3,4,19
MN - Blue Earth County,Blue Earth County,MN,4,5,3,1,1,4,18
MN - Carlton County,Carlton County,MN,3,4,3,1,3,4,18
MN - Faribault County,Faribault County,MN,4,5,3,1,1,4,18
MN - Le Sueur County,Le Sueur County,MN,4,5,3,1,1,4,18
MN - McLeod County,McLeod County,MN,4,5,3,1,1,4,18
MN - Martin County,Martin County,MN,4,5,3,1,1,4,18
MN - Pine County,Pine County,MN,3,4,3,1,3,4,18
MN - Brown County,Brown County,MN,3,5,3,1,1,4,17
MN - Cottonwood County,Cottonwood County,MN,4,4,3,1,1,4,17
MN - Freeborn County,Freeborn County,MN,3,5,3,1,1,4,17
MN - Hubbard County,Hubbard County,MN,3,1,3,1,4,4,16
MN - Mille Lacs County,Mille Lacs County,MN,3,2,3,1,3,4,16
MN - Nicollet County,Nicollet County,MN,3,5,3,1,1,4,17
MN - Ramsey County,Ramsey County,MN,3,5,3,1,1,4,17
MN - Renville County,Renville County,MN,4,4,3,1,1,4,17
MN - Sibley County,Sibley County,MN,3,5,3,1,1,4,17
MN - Waseca County,Waseca County,MN,4,4,3,1,1,4,17
MN - Carver County,Carver County,MN,3,4,3,1,1,4,16
MN - Dakota County,Dakota County,MN,3,4,3,1,1,4,16
MN - Dodge County,Dodge County,MN,3,4,3,1,1,4,16
MN - Fillmore County,Fillmore County,MN,3,4,3,1,1,4,16
MN - Goodhue County,Goodhue County,MN,3,4,3,1,1,4,16
MN - Hennepin County,Hennepin County,MN,3,4,3,1,1,4,16
MN - Jackson County,Jackson County,MN,4,2,3,1,1,4,15
MN - Kandiyohi County,Kandiyohi County,MN,3,4,3,1,1,4,16
MN - Lake County,Lake County,MN,3,1,1,1,6,4,16
MN - Lincoln County,Lincoln County,MN,4,2,3,1,1,4,15
MN - Lyon County,Lyon County,MN,4,2,3,1,1,4,15
MN - Meeker County,Meeker County,MN,3,4,3,1,1,4,16
MN - Mower County,Mower County,MN,3,4,3,1,1,4,16
MN - Norman County,Norman County,MN,4,2,3,1,1,4,15
MN - Olmsted County,Olmsted County,MN,3,4,3,1,1,4,16
MN - Redwood County,Redwood County,MN,4,2,3,1,1,4,15
MN - Rice County,Rice County,MN,3,4,3,1,1,4,16
MN - Scott County,Scott County,MN,3,4,3,1,1,4,16
MN - Stearns County,Stearns County,MN,3,4,3,1,1,4,16
MN - Steele County,Steele County,MN,3,4,3,1,1,4,16
MN - Wabasha County,Wabasha County,MN,3,4,3,1,1,4,16
MN - Washington County,Washington County,MN,3,4,3,1,1,4,16
MN - Watonwan County,Watonwan County,MN,3,4,3,1,1,4,16
MN - Winona County,Winona County,MN,3,4,3,1,1,4,16
MN - Wright County,Wright County,MN,3,4,3,1,1,4,16
MN - Yellow Medicine County,Yellow Medicine County,MN,4,2,3,1,1,4,15
MN - Chippewa County,Chippewa County,MN,4,1,3,1,1,4,14
MN - Chisago County,Chisago County,MN,3,2,3,1,1,4,14
MN - Clay County,Clay County,MN,4,1,3,1,1,4,14
MN - Isanti County,Isanti County,MN,3,2,3,1,1,4,14
MN - Kanabec County,Kanabec County,MN,3,1,3,1,2,4,14
MN - Lac qui Parle County,Lac qui Parle County,MN,4,1,3,1,1,4,14
MN - Otter Tail County,Otter Tail County,MN,3,2,3,1,1,4,14
MN - Pipestone County,Pipestone County,MN,4,1,3,1,1,4,14
MN - Pope County,Pope County,MN,4,1,3,1,1,4,14
MN - Rock County,Rock County,MN,4,1,3,1,1,4,14
MN - Sherburne County,Sherburne County,MN,3,2,3,1,1,4,14
MN - Swift County,Swift County,MN,4,1,3,1,1,4,14
MN - Todd County,Todd County,MN,3,2,3,1,1,4,14
MN - Wadena County,Wadena County,MN,3,2,3,1,1,4,14
MN - Anoka County,Anoka County,MN,3,1,3,1,1,4,13
MN - Becker County,Becker County,MN,3,1,3,1,1,4,13
MN - Benton County,Benton County,MN,3,1,3,1,1,4,13
MN - Big Stone County,Big Stone County,MN,3,1,3,1,1,4,13
MN - Cook County,Cook County,MN,3,1,1,1,6,2,14
MN - Douglas County,Douglas County,MN,3,1,3,1,1,4,13
MN - Grant County,Grant County,MN,3,1,3,1,1,4,13
MN - Houston County,Houston County,MN,3,1,3,1,1,4,13
MN - Kittson County,Kittson County,MN,3,1,3,1,1,4,13
MN - Lake of the Woods County,Lake of the Woods County,MN,3,1,3,1,1,4,13
MN - Mahnomen County,Mahnomen County,MN,3,1,3,1,1,4,13
MN - Marshall County,Marshall County,MN,3,1,3,1,1,4,13
MN - Murray County,Murray County,MN,3,1,3,1,1,4,13
MN - Nobles County,Nobles County,MN,3,1,3,1,1,4,13
MN - Pennington County,Pennington County,MN,3,1,3,1,1,4,13
MN - Polk County,Polk County,MN,3,1,3,1,1,4,13
MN - Red Lake County,Red Lake County,MN,3,1,3,1,1,4,13
MN - Roseau County,Roseau County,MN,3,1,3,1,1,4,13
MN - Stevens County,Stevens County,MN,3,1,3,1,1,4,13
MN - Traverse County,Traverse County,MN,3,1,3,1,1,4,13
MN - Wilkin County,Wilkin County,MN,3,1,3,1,1,4,13
MO - Camden County,Camden County,MO,6,6,8,1,2,6,29
MO - Hickory County,Hickory County,MO,6,5,8,1,2,7,29
MO - Wayne County,Wayne County,MO,6,7,8,1,2,6,30
MO - Bollinger County,Bollinger County,MO,6,6,8,1,2,6,29
MO - Dunklin County,Dunklin County,MO,6,7,8,1,1,5,28
MO - Maries County,Maries County,MO,6,7,7,1,2,6,29
MO - Phelps County,Phelps County,MO,6,7,8,1,2,5,29
MO - Ripley County,Ripley County,MO,6,5,8,1,2,6,28
MO - Cape Girardeau County,Cape Girardeau County,MO,6,7,8,1,1,5,28
MO - Carter County,Carter County,MO,6,9,6,1,2,5,29
MO - Cedar County,Cedar County,MO,6,5,8,1,2,5,27
MO - Morgan County,Morgan County,MO,4,5,8,1,2,6,26
MO - New Madrid County,New Madrid County,MO,6,7,8,1,1,5,28
MO - Osage County,Osage County,MO,6,7,8,1,1,5,28
MO - Pemiscot County,Pemiscot County,MO,6,7,8,1,1,5,28
MO - Scott County,Scott County,MO,6,7,8,1,1,5,28
MO - Stone County,Stone County,MO,6,2,8,1,2,6,25
MO - Bates County,Bates County,MO,6,4,8,1,3,5,27
MO - Butler County,Butler County,MO,6,5,8,1,2,5,27
MO - Christian County,Christian County,MO,6,2,8,1,2,6,25
MO - Cole County,Cole County,MO,6,7,7,1,1,5,27
MO - Dallas County,Dallas County,MO,4,5,8,1,2,6,26
MO - Franklin County,Franklin County,MO,6,7,7,1,1,5,27
MO - Gasconade County,Gasconade County,MO,6,7,7,1,1,5,27
MO - Laclede County,Laclede County,MO,4,5,8,1,2,5,25
MO - Miller County,Miller County,MO,6,6,7,1,2,5,27
MO - Mississippi County,Mississippi County,MO,6,6,8,1,1,5,27
MO - Perry County,Perry County,MO,6,6,8,1,1,5,27
MO - St. Clair County,St. Clair County,MO,6,2,8,1,2,6,25
MO - Ste. Genevieve County,Ste. Genevieve County,MO,6,6,8,1,1,5,27
MO - Vernon County,Vernon County,MO,6,4,8,1,2,5,26
MO - Barton County,Barton County,MO,6,4,8,1,2,5,26
MO - Benton County,Benton County,MO,4,2,8,1,2,6,23
MO - Carroll County,Carroll County,MO,6,6,7,1,1,5,26
MO - Chariton County,Chariton County,MO,6,6,6,1,2,5,26
MO - Clay County,Clay County,MO,6,4,8,1,2,5,26
MO - Crawford County,Crawford County,MO,6,7,5,1,2,5,26
MO - Dade County,Dade County,MO,6,2,8,1,2,5,24
MO - Dent County,Dent County,MO,6,5,7,1,2,5,26
MO - Henry County,Henry County,MO,6,4,8,1,2,5,26
MO - Jasper County,Jasper County,MO,6,2,8,1,2,5,24
MO - Jefferson County,Jefferson County,MO,6,5,6,1,2,6,26
MO - Johnson County,Johnson County,MO,6,4,8,1,2,5,26
MO - Lafayette County,Lafayette County,MO,6,5,7,1,1,6,26
MO - Lawrence County,Lawrence County,MO,6,2,8,1,2,5,24
MO - Platte County,Platte County,MO,6,4,8,1,2,5,26
MO - Polk County,Polk County,MO,6,2,8,1,2,5,24
MO - Pulaski County,Pulaski County,MO,4,5,8,1,2,5,25
MO - Ray County,Ray County,MO,6,4,7,1,2,6,26
MO - Reynolds County,Reynolds County,MO,6,7,5,1,2,5,26
MO - St. Francois County,St. Francois County,MO,6,5,7,1,2,5,26
MO - Saline County,Saline County,MO,6,5,7,1,2,5,26
MO - Stoddard County,Stoddard County,MO,6,5,8,1,1,5,26
MO - Taney County,Taney County,MO,6,2,8,1,2,5,24
MO - Texas County,Texas County,MO,4,5,8,1,2,5,25
MO - Warren County,Warren County,MO,6,6,7,1,1,5,26
MO - Washington County,Washington County,MO,6,7,5,1,2,5,26
MO - Barry County,Barry County,MO,4,2,8,1,2,5,22
MO - Boone County,Boone County,MO,6,4,7,1,2,5,25
MO - Cass County,Cass County,MO,4,2,8,1,2,6,23
MO - Cooper County,Cooper County,MO,4,5,7,1,2,5,24
MO - Greene County,Greene County,MO,6,2,8,1,2,5,24
MO - Howard County,Howard County,MO,4,5,7,1,2,5,24
MO - Howell County,Howell County,MO,6,1,8,1,2,5,23
MO - Jackson County,Jackson County,MO,4,4,8,1,2,5,24
MO - McDonald County,McDonald County,MO,4,2,8,1,2,5,22
MO - Madison County,Madison County,MO,6,6,5,1,2,5,25
MO - Moniteau County,Moniteau County,MO,4,6,7,1,1,5,24
MO - Newton County,Newton County,MO,4,2,8,1,2,5,22
MO - Pettis County,Pettis County,MO,4,5,7,1,2,5,24
MO - St. Louis County,St. Louis County,MO,6,5,7,1,1,5,25
MO - Webster County,Webster County,MO,4,2,8,1,2,5,22
MO - Wright County,Wright County,MO,4,4,8,1,2,5,24
MO - Atchison County,Atchison County,MO,6,5,6,1,1,5,24
MO - Douglas County,Douglas County,MO,4,2,8,1,2,5,22
MO - Lincoln County,Lincoln County,MO,6,4,6,1,1,6,24
MO - Livingston County,Livingston County,MO,6,4,6,1,2,5,24
MO - Marion County,Marion County,MO,4,5,6,1,2,5,23
MO - Monroe County,Monroe County,MO,4,5,6,1,2,5,23
MO - Ozark County,Ozark County,MO,4,2,7,1,2,6,22
MO - Ralls County,Ralls County,MO,4,5,6,1,2,5,23
MO - Randolph County,Randolph County,MO,4,5,6,1,2,5,23
MO - Andrew County,Andrew County,MO,4,4,7,1,1,5,22
MO - Audrain County,Audrain County,MO,4,4,6,1,2,5,22
MO - Buchanan County,Buchanan County,MO,4,4,7,1,1,5,22
MO - Callaway County,Callaway County,MO,4,5,6,1,1,5,22
MO - Clark County,Clark County,MO,4,5,5,1,2,5,22
MO - Lewis County,Lewis County,MO,4,5,5,1,2,5,22
MO - Linn County,Linn County,MO,4,5,5,1,2,5,22
MO - Montgomery County,Montgomery County,MO,4,5,6,1,1,5,22
MO - Nodaway County,Nodaway County,MO,4,5,6,1,1,5,22
MO - Pike County,Pike County,MO,6,4,6,1,1,5,23
MO - St. Charles County,St. Charles County,MO,4,4,7,1,1,5,22
MO - Scotland County,Scotland County,MO,6,4,5,1,2,5,23
MO - Caldwell County,Caldwell County,MO,4,4,6,1,1,5,21
MO - DeKalb County,DeKalb County,MO,4,4,6,1,1,5,21
MO - Gentry County,Gentry County,MO,4,4,6,1,1,5,21
MO - Grundy County,Grundy County,MO,4,4,5,1,2,5,21
MO - Holt County,Holt County,MO,4,4,6,1,1,5,21
MO - Iron County,Iron County,MO,6,4,4,1,2,5,22
MO - Knox County,Knox County,MO,4,4,5,1,2,5,21
MO - Macon County,Macon County,MO,4,4,5,1,2,5,21
MO - Shelby County,Shelby County,MO,4,4,5,1,2,5,21
MO - Sullivan County,Sullivan County,MO,4,4,5,1,2,5,21
MO - Adair County,Adair County,MO,4,4,4,1,2,5,20
MO - Clinton County,Clinton County,MO,4,2,6,1,1,5,19
MO - Daviess County,Daviess County,MO,4,4,5,1,1,5,20
MO - Harrison County,Harrison County,MO,4,4,5,1,1,5,20
MO - Mercer County,Mercer County,MO,4,4,4,1,2,5,20
MO - Putnam County,Putnam County,MO,4,4,4,1,2,5,20
MO - Schuyler County,Schuyler County,MO,4,4,4,1,2,5,20
MO - Shannon County,Shannon County,MO,6,7,1,1,2,5,22
MO - Worth County,Worth County,MO,4,4,5,1,1,5,20
MO - Oregon County,Oregon County,MO,6,4,1,1,2,5,19
MO - St. Louis city,St. Louis city,MO,6,5,1,1,1,5,19
MS - Jackson County,Jackson County,MS,6,9,8,4,3,8,38
MS - Harrison County,Harrison County,MS,7,7,8,4,2,7,35
MS - Clarke County,Clarke County,MS,7,6,9,1,1,7,31
MS - Stone County,Stone County,MS,7,6,8,1,1,8,31
MS - Carroll County,Carroll County,MS,7,7,8,1,1,6,30
MS - Jefferson Davis County,Jefferson Davis County,MS,6,5,9,1,1,8,30
MS - Lamar County,Lamar County,MS,6,7,8,1,1,7,30
MS - Perry County,Perry County,MS,6,6,9,1,1,7,30
MS - Simpson County,Simpson County,MS,7,6,8,1,1,7,30
MS - Walthall County,Walthall County,MS,7,5,8,1,1,8,30
MS - Warren County,Warren County,MS,7,9,9,1,1,5,32
MS - Amite County,Amite County,MS,7,4,8,1,1,8,29
MS - Copiah County,Copiah County,MS,7,4,9,1,1,7,29
MS - George County,George County,MS,6,5,8,1,1,8,29
MS - Greene County,Greene County,MS,6,5,8,1,1,8,29
MS - Lawrence County,Lawrence County,MS,7,5,8,1,1,7,29
MS - Lincoln County,Lincoln County,MS,7,5,8,1,1,7,29
MS - Neshoba County,Neshoba County,MS,7,7,9,1,1,5,30
MS - Smith County,Smith County,MS,7,5,8,1,1,7,29
MS - Tate County,Tate County,MS,7,9,8,1,1,5,31
MS - Wilkinson County,Wilkinson County,MS,7,2,9,1,1,8,28
MS - Claiborne County,Claiborne County,MS,7,6,9,1,1,5,29
MS - Clay County,Clay County,MS,7,7,8,1,1,5,29
MS - Covington County,Covington County,MS,6,5,8,1,1,7,28
MS - Forrest County,Forrest County,MS,6,6,9,1,1,6,29
MS - Franklin County,Franklin County,MS,7,4,8,1,1,7,28
MS - Jasper County,Jasper County,MS,7,5,9,1,1,6,29
MS - Jefferson County,Jefferson County,MS,7,4,8,1,1,7,28
MS - Lafayette County,Lafayette County,MS,7,7,8,1,1,5,29
MS - Lee County,Lee County,MS,7,7,8,1,1,5,29
MS - Lowndes County,Lowndes County,MS,7,7,8,1,1,5,29
MS - Marion County,Marion County,MS,6,5,8,1,1,7,28
MS - Monroe County,Monroe County,MS,7,7,8,1,1,5,29
MS - Pike County,Pike County,MS,7,4,8,1,1,7,28
MS - Wayne County,Wayne County,MS,7,5,8,1,1,6,28
MS - Winston County,Winston County,MS,7,7,8,1,1,5,29
MS - Hinds County,Hinds County,MS,7,5,9,1,1,5,28
MS - Holmes County,Holmes County,MS,7,6,8,1,1,5,28
MS - Humphreys County,Humphreys County,MS,7,7,8,1,1,5,29
MS - Jones County,Jones County,MS,7,5,8,1,1,6,28
MS - Leake County,Leake County,MS,7,6,8,1,1,5,28
MS - Madison County,Madison County,MS,7,6,8,1,1,5,28
MS - Marshall County,Marshall County,MS,7,6,8,1,1,5,28
MS - Noxubee County,Noxubee County,MS,7,6,8,1,1,5,28
MS - Oktibbeha County,Oktibbeha County,MS,7,6,8,1,1,5,28
MS - Rankin County,Rankin County,MS,7,6,8,1,1,5,28
MS - Sharkey County,Sharkey County,MS,9,9,6,1,1,5,31
MS - Yalobusha County,Yalobusha County,MS,7,6,8,1,1,5,28
MS - Yazoo County,Yazoo County,MS,7,7,8,1,1,5,29
MS - Adams County,Adams County,MS,7,2,8,1,1,6,25
MS - Calhoun County,Calhoun County,MS,6,6,8,1,1,5,27
MS - Grenada County,Grenada County,MS,6,6,8,1,1,5,27
MS - Issaquena County,Issaquena County,MS,9,5,8,1,1,5,29
MS - Kemper County,Kemper County,MS,7,5,8,1,1,5,27
MS - Lauderdale County,Lauderdale County,MS,7,4,9,1,1,5,27
MS - Newton County,Newton County,MS,7,4,8,1,1,6,27
MS - Panola County,Panola County,MS,7,5,8,1,1,5,27
MS - Pearl River County,Pearl River County,MS,4,5,8,1,1,7,26
MS - Pontotoc County,Pontotoc County,MS,6,6,8,1,1,5,27
MS - Scott County,Scott County,MS,7,5,8,1,1,5,27
MS - Sunflower County,Sunflower County,MS,7,7,7,1,1,5,28
MS - Attala County,Attala County,MS,6,5,8,1,1,5,26
MS - Benton County,Benton County,MS,6,5,8,1,1,5,26
MS - Chickasaw County,Chickasaw County,MS,6,5,8,1,1,5,26
MS - DeSoto County,DeSoto County,MS,7,4,8,1,1,5,26
MS - Hancock County,Hancock County,MS,4,6,1,6,2,9,28
MS - Itawamba County,Itawamba County,MS,6,5,8,1,1,5,26
MS - Leflore County,Leflore County,MS,7,6,7,1,1,5,27
MS - Prentiss County,Prentiss County,MS,6,6,8,1,1,5,27
MS - Tippah County,Tippah County,MS,6,5,8,1,1,5,26
MS - Union County,Union County,MS,6,5,8,1,1,5,26
MS - Webster County,Webster County,MS,6,5,8,1,1,5,26
MS - Alcorn County,Alcorn County,MS,6,5,8,1,1,5,26
MS - Bolivar County,Bolivar County,MS,7,5,7,1,1,5,26
MS - Choctaw County,Choctaw County,MS,6,4,8,1,1,5,25
MS - Coahoma County,Coahoma County,MS,7,4,8,1,1,5,26
MS - Montgomery County,Montgomery County,MS,6,4,8,1,1,5,25
MS - Quitman County,Quitman County,MS,7,4,8,1,1,5,26
MS - Tunica County,Tunica County,MS,7,4,8,1,1,5,26
MS - Washington County,Washington County,MS,7,6,6,1,1,5,26
MS - Tallahatchie County,Tallahatchie County,MS,6,4,8,1,1,5,25
MS - Tishomingo County,Tishomingo County,MS,6,4,8,1,1,5,25
MT - Big Horn County,Big Horn County,MT,6,1,4,1,7,4,23
MT - Rosebud County,Rosebud County,MT,6,1,4,1,7,4,23
MT - Carter County,Carter County,MT,4,2,4,1,6,4,21
MT - Custer County,Custer County,MT,6,1,4,1,6,4,22
MT - Dawson County,Dawson County,MT,6,2,4,1,6,4,23
MT - Garfield County,Garfield County,MT,4,1,4,1,7,4,21
MT - Sanders County,Sanders County,MT,6,1,3,1,7,4,22
MT - Blaine County,Blaine County,MT,4,1,4,1,6,4,20
MT - Fergus County,Fergus County,MT,3,1,4,1,7,4,20
MT - Flathead County,Flathead County,MT,4,1,3,1,7,4,20
MT - Musselshell County,Musselshell County,MT,6,1,4,1,6,4,22
MT - Petroleum County,Petroleum County,MT,6,1,4,1,6,4,22
MT - Phillips County,Phillips County,MT,4,1,4,1,6,4,20
MT - Prairie County,Prairie County,MT,6,1,4,1,6,4,22
MT - Valley County,Valley County,MT,4,1,4,1,6,4,20
MT - Yellowstone County,Yellowstone County,MT,4,1,4,1,6,4,20
MT - Chouteau County,Chouteau County,MT,4,1,3,1,6,4,19
MT - Hill County,Hill County,MT,4,1,4,1,6,4,20
MT - Lewis and Clark County,Lewis and Clark County,MT,4,1,3,1,6,4,19
MT - McCone County,McCone County,MT,4,1,4,1,6,4,20
MT - Treasure County,Treasure County,MT,4,1,4,1,6,4,20
MT - Carbon County,Carbon County,MT,4,1,3,1,6,4,19
MT - Fallon County,Fallon County,MT,4,1,4,1,5,4,19
MT - Lake County,Lake County,MT,3,1,3,1,6,4,18
MT - Ravalli County,Ravalli County,MT,3,1,3,1,6,4,18
MT - Richland County,Richland County,MT,6,1,4,1,4,4,20
MT - Stillwater County,Stillwater County,MT,4,1,3,1,6,4,19
MT - Sweet Grass County,Sweet Grass County,MT,4,1,3,1,6,4,19
MT - Golden Valley County,Golden Valley County,MT,4,1,3,1,5,4,18
MT - Lincoln County,Lincoln County,MT,6,1,1,1,6,4,19
MT - Powder River County,Powder River County,MT,6,1,1,1,6,4,19
MT - Roosevelt County,Roosevelt County,MT,4,1,4,1,4,4,18
MT - Beaverhead County,Beaverhead County,MT,3,1,1,1,7,4,17
MT - Cascade County,Cascade County,MT,4,1,1,1,6,4,17
MT - Daniels County,Daniels County,MT,4,1,4,1,3,4,17
MT - Gallatin County,Gallatin County,MT,4,1,1,1,6,4,17
MT - Missoula County,Missoula County,MT,4,1,1,1,6,4,17
MT - Sheridan County,Sheridan County,MT,4,1,4,1,3,4,17
MT - Toole County,Toole County,MT,3,1,3,1,5,4,17
MT - Wheatland County,Wheatland County,MT,3,1,3,1,5,4,17
MT - Wibaux County,Wibaux County,MT,4,1,4,1,3,4,17
MT - Broadwater County,Broadwater County,MT,4,1,1,1,6,4,17
MT - Madison County,Madison County,MT,3,1,1,1,6,4,16
MT - Meagher County,Meagher County,MT,3,1,1,1,6,4,16
MT - Mineral County,Mineral County,MT,4,1,1,1,6,4,17
MT - Pondera County,Pondera County,MT,3,1,3,1,4,4,16
MT - Granite County,Granite County,MT,4,1,1,1,6,3,16
MT - Jefferson County,Jefferson County,MT,3,1,1,1,6,4,16
MT - Judith Basin County,Judith Basin County,MT,3,1,1,1,6,4,16
MT - Liberty County,Liberty County,MT,4,1,1,1,5,4,16
MT - Powell County,Powell County,MT,3,1,1,1,6,4,16
MT - Teton County,Teton County,MT,3,1,1,1,6,4,16
MT - Park County,Park County,MT,3,1,1,1,6,3,15
MT - Deer Lodge County,Deer Lodge County,MT,3,1,1,1,3,4,13
MT - Glacier County,Glacier County,MT,3,1,1,1,3,4,13
MT - Silver Bow County,Silver Bow County,MT,3,1,1,1,3,4,13
NC - Hyde County,Hyde County,NC,4,7,7,10,2,9,39
NC - Pamlico County,Pamlico County,NC,4,7,8,6,2,10,37
NC - Tyrrell County,Tyrrell County,NC,4,7,7,10,2,8,38
NC - Pender County,Pender County,NC,4,6,8,6,3,8,35
NC - Beaufort County,Beaufort County,NC,4,7,7,6,2,8,34
NC - Camden County,Camden County,NC,4,7,7,6,2,8,34
NC - Craven County,Craven County,NC,4,7,8,4,3,6,32
NC - Currituck County,Currituck County,NC,4,7,7,6,2,8,34
NC - Gates County,Gates County,NC,6,6,8,4,2,7,33
NC - Jones County,Jones County,NC,4,7,8,3,2,8,32
NC - Perquimans County,Perquimans County,NC,4,7,7,4,2,8,32
NC - Chowan County,Chowan County,NC,4,7,8,4,2,6,31
NC - Pasquotank County,Pasquotank County,NC,4,7,7,4,2,7,31
NC - Greene County,Greene County,NC,6,7,8,1,1,6,29
NC - Brunswick County,Brunswick County,NC,4,7,4,4,2,8,29
NC - Carteret County,Carteret County,NC,4,7,3,6,1,9,30
NC - New Hanover County,New Hanover County,NC,4,9,5,4,1,7,30
NC - Bertie County,Bertie County,NC,4,5,8,4,3,5,29
NC - Bladen County,Bladen County,NC,6,5,8,1,3,5,28
NC - Columbus County,Columbus County,NC,4,5,8,3,3,5,28
NC - Lenoir County,Lenoir County,NC,6,7,8,1,1,5,28
NC - Pitt County,Pitt County,NC,6,6,8,3,1,5,29
NC - Wayne County,Wayne County,NC,6,7,8,1,1,5,28
NC - Cumberland County,Cumberland County,NC,6,6,8,1,1,5,27
NC - Hertford County,Hertford County,NC,6,4,8,4,2,5,29
NC - Washington County,Washington County,NC,4,7,6,4,2,5,28
NC - Wilson County,Wilson County,NC,6,6,8,1,1,5,27
NC - Dare County,Dare County,NC,3,6,3,6,1,8,27
NC - Edgecombe County,Edgecombe County,NC,6,5,8,1,1,5,26
NC - Onslow County,Onslow County,NC,4,7,4,4,1,6,26
NC - Duplin County,Duplin County,NC,4,6,8,1,1,5,25
NC - Martin County,Martin County,NC,4,4,8,4,1,5,26
NC - Hoke County,Hoke County,NC,6,2,8,1,1,5,23
NC - Robeson County,Robeson County,NC,6,2,8,1,1,5,23
NC - Sampson County,Sampson County,NC,6,2,8,1,1,5,23
NC - Scotland County,Scotland County,NC,6,2,8,1,1,5,23
NC - Harnett County,Harnett County,NC,6,2,8,1,1,5,23
NC - Northampton County,Northampton County,NC,4,4,7,1,2,5,23
NC - Anson County,Anson County,NC,6,2,7,1,1,5,22
NC - Chatham County,Chatham County,NC,6,2,7,1,1,5,22
NC - Halifax County,Halifax County,NC,4,4,7,1,1,5,22
NC - Johnston County,Johnston County,NC,4,2,8,1,1,5,21
NC - Lee County,Lee County,NC,6,2,7,1,1,5,22
NC - Durham County,Durham County,NC,6,2,6,1,1,5,21
NC - Montgomery County,Montgomery County,NC,4,2,7,1,1,5,20
NC - Nash County,Nash County,NC,6,2,6,1,1,5,21
NC - Richmond County,Richmond County,NC,4,1,8,1,1,5,20
NC - Union County,Union County,NC,6,2,6,1,1,5,21
NC - Moore County,Moore County,NC,4,1,7,1,1,5,19
NC - Alamance County,Alamance County,NC,6,2,4,1,1,5,19
NC - Granville County,Granville County,NC,6,1,5,1,1,5,19
NC - Polk County,Polk County,NC,3,1,7,1,1,5,18
NC - Transylvania County,Transylvania County,NC,6,4,3,1,2,5,21
NC - Vance County,Vance County,NC,6,4,3,1,1,5,20
NC - Cabarrus County,Cabarrus County,NC,6,1,4,1,1,5,18
NC - Franklin County,Franklin County,NC,6,1,4,1,1,5,18
NC - Wake County,Wake County,NC,4,1,5,1,1,5,17
NC - Warren County,Warren County,NC,4,2,4,1,1,5,17
NC - Caswell County,Caswell County,NC,6,2,3,1,1,4,17
NC - Mecklenburg County,Mecklenburg County,NC,4,1,4,1,1,5,16
NC - Orange County,Orange County,NC,4,1,4,1,1,5,16
NC - Randolph County,Randolph County,NC,4,1,5,1,1,4,16
NC - Stanly County,Stanly County,NC,4,1,4,1,1,5,16
NC - Wilkes County,Wilkes County,NC,4,2,3,1,2,4,16
NC - Caldwell County,Caldwell County,NC,4,1,3,1,1,5,15
NC - Catawba County,Catawba County,NC,4,1,3,1,1,5,15
NC - Cherokee County,Cherokee County,NC,4,1,3,1,2,5,16
NC - Cleveland County,Cleveland County,NC,4,1,3,1,1,5,15
NC - Davidson County,Davidson County,NC,4,1,3,1,1,5,15
NC - Davie County,Davie County,NC,4,1,3,1,1,5,15
NC - Gaston County,Gaston County,NC,4,1,3,1,1,5,15
NC - Guilford County,Guilford County,NC,4,1,3,1,1,5,15
NC - Henderson County,Henderson County,NC,3,1,3,1,2,5,15
NC - Iredell County,Iredell County,NC,4,1,3,1,1,5,15
NC - Lincoln County,Lincoln County,NC,4,1,3,1,1,5,15
NC - Rockingham County,Rockingham County,NC,4,1,4,1,1,4,15
NC - Rowan County,Rowan County,NC,4,1,3,1,1,5,15
NC - Yadkin County,Yadkin County,NC,4,1,3,1,1,5,15
NC - Alexander County,Alexander County,NC,4,1,3,1,1,4,14
NC - Alleghany County,Alleghany County,NC,3,1,3,1,2,4,14
NC - Avery County,Avery County,NC,3,1,3,1,2,4,14
NC - Burke County,Burke County,NC,4,1,3,1,1,4,14
NC - Clay County,Clay County,NC,3,1,3,1,2,4,14
NC - Forsyth County,Forsyth County,NC,4,1,3,1,1,4,14
NC - Graham County,Graham County,NC,3,1,3,1,2,4,14
NC - Haywood County,Haywood County,NC,3,1,3,1,2,4,14
NC - Jackson County,Jackson County,NC,3,1,3,1,2,4,14
NC - McDowell County,McDowell County,NC,3,1,3,1,1,5,14
NC - Macon County,Macon County,NC,3,1,3,1,2,4,14
NC - Mitchell County,Mitchell County,NC,3,1,3,1,2,4,14
NC - Person County,Person County,NC,4,1,3,1,1,4,14
NC - Rutherford County,Rutherford County,NC,3,1,3,1,1,5,14
NC - Stokes County,Stokes County,NC,4,1,3,1,1,4,14
NC - Surry County,Surry County,NC,4,1,3,1,1,4,14
NC - Swain County,Swain County,NC,3,1,3,1,2,4,14
NC - Watauga County,Watauga County,NC,3,1,3,1,2,4,14
NC - Ashe County,Ashe County,NC,3,1,3,1,2,4,14
NC - Buncombe County,Buncombe County,NC,3,1,3,1,2,4,14
NC - Madison County,Madison County,NC,3,1,3,1,2,4,14
NC - Yancey County,Yancey County,NC,1,1,3,1,2,4,12
ND - Billings County,Billings County,ND,4,2,4,1,3,4,18
ND - Bowman County,Bowman County,ND,4,1,4,1,3,5,18
ND - Hettinger County,Hettinger County,ND,4,1,4,1,3,5,18
ND - McKenzie County,McKenzie County,ND,4,2,3,1,4,4,18
ND - Slope County,Slope County,ND,4,1,4,1,3,5,18
ND - Dunn County,Dunn County,ND,4,1,4,1,3,4,17
ND - Sioux County,Sioux County,ND,4,2,3,1,3,4,17
ND - Adams County,Adams County,ND,4,1,3,1,3,4,16
ND - Golden Valley County,Golden Valley County,ND,4,1,3,1,3,4,16
ND - Grant County,Grant County,ND,4,1,3,1,3,4,16
ND - McIntosh County,McIntosh County,ND,4,2,3,1,1,5,16
ND - Sargent County,Sargent County,ND,4,2,3,1,1,5,16
ND - Stark County,Stark County,ND,4,1,3,1,3,4,16
ND - Dickey County,Dickey County,ND,4,1,3,1,1,5,15
ND - Emmons County,Emmons County,ND,4,2,3,1,1,4,15
ND - LaMoure County,LaMoure County,ND,4,1,3,1,1,5,15
ND - Richland County,Richland County,ND,4,1,3,1,1,5,15
ND - Burleigh County,Burleigh County,ND,4,1,3,1,1,4,14
ND - Cass County,Cass County,ND,4,1,3,1,1,4,14
ND - Kidder County,Kidder County,ND,4,1,3,1,1,4,14
ND - Logan County,Logan County,ND,4,1,3,1,1,4,14
ND - McLean County,McLean County,ND,4,1,3,1,1,4,14
ND - Mercer County,Mercer County,ND,4,1,3,1,1,4,14
ND - Morton County,Morton County,ND,4,1,3,1,1,4,14
ND - Oliver County,Oliver County,ND,4,1,3,1,1,4,14
ND - Ransom County,Ransom County,ND,4,1,3,1,1,4,14
ND - Stutsman County,Stutsman County,ND,4,1,3,1,1,4,14
ND - Wells County,Wells County,ND,4,1,3,1,1,4,14
ND - Barnes County,Barnes County,ND,3,1,3,1,1,4,13
ND - Benson County,Benson County,ND,3,1,3,1,1,4,13
ND - Burke County,Burke County,ND,3,1,3,1,1,4,13
ND - Cavalier County,Cavalier County,ND,3,1,3,1,1,4,13
ND - Divide County,Divide County,ND,4,1,3,1,1,4,14
ND - Eddy County,Eddy County,ND,3,1,3,1,1,4,13
ND - Foster County,Foster County,ND,3,1,3,1,1,4,13
ND - Grand Forks County,Grand Forks County,ND,3,1,3,1,1,4,13
ND - Griggs County,Griggs County,ND,3,1,3,1,1,4,13
ND - McHenry County,McHenry County,ND,4,1,3,1,1,4,14
ND - Nelson County,Nelson County,ND,3,1,3,1,1,4,13
ND - Pembina County,Pembina County,ND,3,1,3,1,1,4,13
ND - Pierce County,Pierce County,ND,4,1,3,1,1,4,14
ND - Ramsey County,Ramsey County,ND,3,1,3,1,1,4,13
ND - Rolette County,Rolette County,ND,3,1,3,1,1,4,13
ND - Sheridan County,Sheridan County,ND,4,1,3,1,1,4,14
ND - Steele County,Steele County,ND,3,1,3,1,1,4,13
ND - Towner County,Towner County,ND,3,1,3,1,1,4,13
ND - Traill County,Traill County,ND,3,1,3,1,1,4,13
ND - Walsh County,Walsh County,ND,3,1,3,1,1,4,13
ND - Williams County,Williams County,ND,4,1,3,1,1,4,14
ND - Bottineau County,Bottineau County,ND,3,1,3,1,1,4,13
ND - Mountrail County,Mountrail County,ND,3,1,3,1,1,4,13
ND - Renville County,Renville County,ND,3,1,3,1,1,4,13
ND - Ward County,Ward County,ND,3,1,3,1,1,4,13
NE - Cherry County,Cherry County,NE,6,2,4,1,6,5,24
NE - Furnas County,Furnas County,NE,7,2,6,1,2,5,23
NE - Franklin County,Franklin County,NE,6,2,7,1,1,5,22
NE - Gosper County,Gosper County,NE,4,2,7,1,2,5,21
NE - Hall County,Hall County,NE,6,2,7,1,1,5,22
NE - Harlan County,Harlan County,NE,6,2,7,1,1,5,22
NE - Nemaha County,Nemaha County,NE,6,4,6,1,1,5,23
NE - Nuckolls County,Nuckolls County,NE,6,2,7,1,1,5,22
NE - Pawnee County,Pawnee County,NE,6,2,7,1,1,5,22
NE - Richardson County,Richardson County,NE,6,2,7,1,1,5,22
NE - Webster County,Webster County,NE,6,2,7,1,1,5,22
NE - Adams County,Adams County,NE,6,2,6,1,1,5,21
NE - Clay County,Clay County,NE,6,2,6,1,1,5,21
NE - Dundy County,Dundy County,NE,7,2,5,1,1,5,21
NE - Gage County,Gage County,NE,6,2,6,1,1,5,21
NE - Garden County,Garden County,NE,6,2,4,1,3,5,21
NE - Hitchcock County,Hitchcock County,NE,6,2,5,1,2,5,21
NE - Howard County,Howard County,NE,6,2,6,1,1,5,21
NE - Jefferson County,Jefferson County,NE,6,2,6,1,1,5,21
NE - Johnson County,Johnson County,NE,6,2,6,1,1,5,21
NE - Kearney County,Kearney County,NE,6,2,6,1,1,5,21
NE - Lancaster County,Lancaster County,NE,6,2,6,1,1,5,21
NE - Merrick County,Merrick County,NE,6,2,6,1,1,5,21
NE - Otoe County,Otoe County,NE,6,2,6,1,1,5,21
NE - Phelps County,Phelps County,NE,6,2,6,1,1,5,21
NE - Red Willow County,Red Willow County,NE,6,2,5,1,2,5,21
NE - Saline County,Saline County,NE,6,2,6,1,1,5,21
NE - Thayer County,Thayer County,NE,6,2,6,1,1,5,21
NE - York County,York County,NE,6,2,6,1,1,5,21
NE - Blaine County,Blaine County,NE,6,2,4,1,2,5,20
NE - Colfax County,Colfax County,NE,6,2,5,1,1,5,20
NE - Custer County,Custer County,NE,4,1,5,1,3,5,19
NE - Douglas County,Douglas County,NE,6,2,5,1,1,5,20
NE - Fillmore County,Fillmore County,NE,4,2,6,1,1,5,19
NE - Frontier County,Frontier County,NE,6,2,4,1,2,5,20
NE - Hamilton County,Hamilton County,NE,4,2,6,1,1,5,19
NE - Holt County,Holt County,NE,6,2,5,1,1,5,20
NE - Platte County,Platte County,NE,6,2,5,1,1,5,20
NE - Sarpy County,Sarpy County,NE,4,2,6,1,1,5,19
NE - Seward County,Seward County,NE,4,2,6,1,1,5,19
NE - Sherman County,Sherman County,NE,6,1,6,1,1,5,20
NE - Thomas County,Thomas County,NE,6,2,4,1,2,5,20
NE - Boyd County,Boyd County,NE,4,2,5,1,1,5,18
NE - Buffalo County,Buffalo County,NE,4,1,6,1,1,5,18
NE - Butler County,Butler County,NE,4,1,6,1,1,5,18
NE - Cass County,Cass County,NE,4,2,5,1,1,5,18
NE - Cheyenne County,Cheyenne County,NE,6,1,4,1,2,5,19
NE - Dawson County,Dawson County,NE,4,2,5,1,1,5,18
NE - Dodge County,Dodge County,NE,4,2,5,1,1,5,18
NE - Hayes County,Hayes County,NE,6,1,4,1,2,5,19
NE - Keith County,Keith County,NE,6,2,4,1,1,5,19
NE - Keya Paha County,Keya Paha County,NE,4,1,6,1,1,5,18
NE - Loup County,Loup County,NE,4,1,5,1,2,5,18
NE - Nance County,Nance County,NE,4,2,5,1,1,5,18
NE - Polk County,Polk County,NE,4,1,6,1,1,5,18
NE - Saunders County,Saunders County,NE,4,2,5,1,1,5,18
NE - Sheridan County,Sheridan County,NE,4,1,4,1,3,5,18
NE - Sioux County,Sioux County,NE,6,1,4,1,2,5,19
NE - Thurston County,Thurston County,NE,4,4,4,1,1,5,19
NE - Arthur County,Arthur County,NE,6,1,3,1,2,5,18
NE - Banner County,Banner County,NE,4,1,4,1,2,5,17
NE - Boone County,Boone County,NE,4,1,5,1,1,5,17
NE - Box Butte County,Box Butte County,NE,4,1,4,1,2,5,17
NE - Brown County,Brown County,NE,4,1,5,1,1,5,17
NE - Burt County,Burt County,NE,4,2,4,1,1,5,17
NE - Cedar County,Cedar County,NE,4,1,5,1,1,5,17
NE - Chase County,Chase County,NE,6,1,4,1,1,5,18
NE - Cuming County,Cuming County,NE,4,2,4,1,1,5,17
NE - Dakota County,Dakota County,NE,4,2,4,1,1,5,17
NE - Dawes County,Dawes County,NE,4,1,4,1,2,5,17
NE - Deuel County,Deuel County,NE,6,1,4,1,1,5,18
NE - Garfield County,Garfield County,NE,4,1,5,1,1,5,17
NE - Greeley County,Greeley County,NE,4,1,5,1,1,5,17
NE - Knox County,Knox County,NE,4,1,5,1,1,5,17
NE - Lincoln County,Lincoln County,NE,4,1,3,1,3,5,17
NE - Logan County,Logan County,NE,6,1,3,1,2,5,18
NE - McPherson County,McPherson County,NE,6,1,3,1,2,5,18
NE - Morrill County,Morrill County,NE,4,1,4,1,2,5,17
NE - Perkins County,Perkins County,NE,6,1,4,1,1,5,18
NE - Pierce County,Pierce County,NE,4,2,4,1,1,5,17
NE - Rock County,Rock County,NE,4,1,5,1,1,5,17
NE - Stanton County,Stanton County,NE,4,2,4,1,1,5,17
NE - Valley County,Valley County,NE,4,1,5,1,1,5,17
NE - Washington County,Washington County,NE,4,1,5,1,1,5,17
NE - Wheeler County,Wheeler County,NE,4,1,5,1,1,5,17
NE - Antelope County,Antelope County,NE,4,1,4,1,1,5,16
NE - Dixon County,Dixon County,NE,4,1,4,1,1,5,16
NE - Kimball County,Kimball County,NE,4,1,3,1,2,5,16
NE - Madison County,Madison County,NE,4,1,4,1,1,5,16
NE - Scotts Bluff County,Scotts Bluff County,NE,4,1,4,1,1,5,16
NE - Wayne County,Wayne County,NE,4,1,4,1,1,5,16
NE - Grant County,Grant County,NE,6,1,1,1,2,5,16
NE - Hooker County,Hooker County,NE,6,1,1,1,2,5,16
NH - Rockingham County,Rockingham County,NH,3,4,1,4,1,4,17
NH - Strafford County,Strafford County,NH,3,4,1,3,1,4,16
NH - Belknap County,Belknap County,NH,3,4,1,1,1,4,14
NH - Cheshire County,Cheshire County,NH,3,4,1,1,1,4,14
NH - Hillsborough County,Hillsborough County,NH,3,4,1,1,1,4,14
NH - Merrimack County,Merrimack County,NH,3,4,1,1,1,4,14
NH - Sullivan County,Sullivan County,NH,3,4,1,1,1,4,14
NH - Carroll County,Carroll County,NH,3,4,1,1,1,3,13
NH - Grafton County,Grafton County,NH,3,2,1,1,1,4,12
NH - Coos County,Coos County,NH,3,2,1,1,1,3,11
NJ - Cape May County,Cape May County,NJ,3,5,3,4,2,7,24
NJ - Ocean County,Ocean County,NJ,4,2,3,6,3,5,23
NJ - Salem County,Salem County,NJ,4,4,4,6,1,5,24
NJ - Atlantic County,Atlantic County,NJ,3,4,3,4,3,5,22
NJ - Burlington County,Burlington County,NJ,4,2,3,4,3,5,21
NJ - Gloucester County,Gloucester County,NJ,4,4,3,4,2,5,22
NJ - Camden County,Camden County,NJ,4,2,3,4,2,5,20
NJ - Cumberland County,Cumberland County,NJ,3,2,3,4,3,5,20
NJ - Middlesex County,Middlesex County,NJ,4,4,3,4,1,5,21
NJ - Mercer County,Mercer County,NJ,4,4,3,3,1,5,20
NJ - Monmouth County,Monmouth County,NJ,4,2,3,4,1,5,19
NJ - Hudson County,Hudson County,NJ,4,5,1,4,1,5,20
NJ - Somerset County,Somerset County,NJ,4,4,3,1,1,5,18
NJ - Bergen County,Bergen County,NJ,3,5,1,4,1,5,19
NJ - Essex County,Essex County,NJ,4,5,1,3,1,5,19
NJ - Hunterdon County,Hunterdon County,NJ,4,2,3,1,1,5,16
NJ - Passaic County,Passaic County,NJ,4,5,1,3,1,5,19
NJ - Warren County,Warren County,NJ,4,2,3,1,2,4,16
NJ - Sussex County,Sussex County,NJ,3,2,3,1,2,4,15
NJ - Union County,Union County,NJ,4,4,1,3,1,5,18
NJ - Morris County,Morris County,NJ,4,1,3,1,1,4,14
NM - Luna County,Luna County,NM,9,2,8,1,6,5,31
NM - Chaves County,Chaves County,NM,9,1,8,1,6,6,31
NM - DoÃ±a Ana County,DoÃ±a Ana County,NM,9,2,8,1,6,5,31
NM - Hidalgo County,Hidalgo County,NM,9,2,6,1,7,5,30
NM - Lea County,Lea County,NM,7,1,8,1,6,5,28
NM - Sierra County,Sierra County,NM,9,2,5,1,6,5,28
NM - Grant County,Grant County,NM,6,1,4,1,7,5,24
NM - Socorro County,Socorro County,NM,7,1,4,1,6,5,24
NM - Quay County,Quay County,NM,9,2,5,1,3,5,25
NM - Roosevelt County,Roosevelt County,NM,7,1,7,1,3,5,24
NM - Curry County,Curry County,NM,7,1,6,1,3,5,23
NM - Sandoval County,Sandoval County,NM,4,1,3,1,7,5,21
NM - Eddy County,Eddy County,NM,9,2,1,1,6,5,24
NM - Union County,Union County,NM,4,1,4,1,6,5,21
NM - Rio Arriba County,Rio Arriba County,NM,3,1,3,1,7,4,19
NM - San Juan County,San Juan County,NM,6,1,3,1,6,4,21
NM - Santa Fe County,Santa Fe County,NM,4,1,3,1,6,4,19
NM - Valencia County,Valencia County,NM,7,1,4,1,3,5,21
NM - San Miguel County,San Miguel County,NM,3,1,3,1,6,4,18
NM - Torrance County,Torrance County,NM,4,1,3,1,6,4,19
NM - Catron County,Catron County,NM,7,1,1,1,6,4,20
NM - Guadalupe County,Guadalupe County,NM,7,1,1,1,5,5,20
NM - Otero County,Otero County,NM,3,1,1,1,7,5,18
NM - Lincoln County,Lincoln County,NM,3,1,1,1,6,5,17
NM - Colfax County,Colfax County,NM,3,1,1,1,6,4,16
NM - Mora County,Mora County,NM,3,1,3,1,5,3,16
NM - Bernalillo County,Bernalillo County,NM,6,1,1,1,3,5,17
NM - De Baca County,De Baca County,NM,6,1,1,1,3,5,17
NM - Taos County,Taos County,NM,3,1,3,1,3,4,15
NM - Harding County,Harding County,NM,4,1,1,1,3,4,14
NM - Cibola County,Cibola County,NM,3,1,1,1,3,4,13
NM - Los Alamos County,Los Alamos County,NM,3,1,1,1,3,4,13
NM - McKinley County,McKinley County,NM,3,1,1,1,3,4,13
NV - Churchill County,Churchill County,NV,7,2,1,1,10,5,26
NV - Pershing County,Pershing County,NV,7,1,1,1,10,5,25
NV - Lincoln County,Lincoln County,NV,7,1,1,1,9,5,24
NV - Elko County,Elko County,NV,6,1,1,1,10,4,23
NV - Humboldt County,Humboldt County,NV,6,1,1,1,10,4,23
NV - Lander County,Lander County,NV,4,1,1,1,10,5,22
NV - Nye County,Nye County,NV,6,1,1,1,9,5,23
NV - Washoe County,Washoe County,NV,4,1,1,1,10,4,21
NV - Clark County,Clark County,NV,10,6,1,1,1,5,24
NV - Eureka County,Eureka County,NV,4,1,1,1,9,4,20
NV - Lyon County,Lyon County,NV,7,1,1,1,6,5,21
NV - White Pine County,White Pine County,NV,4,1,1,1,9,4,20
NV - Mineral County,Mineral County,NV,3,1,1,1,8,5,19
NV - Douglas County,Douglas County,NV,6,1,1,1,6,4,19
NV - Esmeralda County,Esmeralda County,NV,9,2,1,1,1,5,19
NV - Storey County,Storey County,NV,3,1,1,1,6,4,16
NV - Carson City,Carson City,NV,6,1,1,1,4,4,17
NY - Columbia County,Columbia County,NY,3,5,3,3,1,4,19
NY - Dutchess County,Dutchess County,NY,3,5,3,3,1,4,19
NY - Greene County,Greene County,NY,3,4,3,4,1,4,19
NY - Orange County,Orange County,NY,3,4,3,3,2,4,19
NY - Rensselaer County,Rensselaer County,NY,3,5,3,3,1,4,19
NY - Richmond County,Richmond County,NY,4,5,1,4,1,5,20
NY - Suffolk County,Suffolk County,NY,3,2,3,4,1,5,18
NY - Ulster County,Ulster County,NY,3,4,3,4,1,4,19
NY - Westchester County,Westchester County,NY,3,4,3,3,1,5,19
NY - Bronx County,Bronx County,NY,4,5,1,3,1,5,19
NY - Queens County,Queens County,NY,4,5,1,3,1,5,19
NY - Saratoga County,Saratoga County,NY,3,5,3,1,1,4,17
NY - Wayne County,Wayne County,NY,3,5,3,1,1,4,17
NY - Albany County,Albany County,NY,3,4,3,1,1,4,16
NY - Allegany County,Allegany County,NY,3,4,3,1,1,4,16
NY - Cayuga County,Cayuga County,NY,3,4,3,1,1,4,16
NY - Chautauqua County,Chautauqua County,NY,3,4,3,1,1,4,16
NY - Chemung County,Chemung County,NY,3,4,3,1,1,4,16
NY - Erie County,Erie County,NY,3,4,3,1,1,4,16
NY - Genesee County,Genesee County,NY,3,4,3,1,1,4,16
NY - Kings County,Kings County,NY,3,5,1,3,1,5,18
NY - Lewis County,Lewis County,NY,3,4,3,1,1,4,16
NY - Livingston County,Livingston County,NY,3,4,3,1,1,4,16
NY - Monroe County,Monroe County,NY,3,4,3,1,1,4,16
NY - Onondaga County,Onondaga County,NY,3,4,3,1,1,4,16
NY - Ontario County,Ontario County,NY,3,4,3,1,1,4,16
NY - Oswego County,Oswego County,NY,3,4,3,1,1,4,16
NY - St. Lawrence County,St. Lawrence County,NY,3,4,3,1,1,4,16
NY - Schenectady County,Schenectady County,NY,3,4,3,1,1,4,16
NY - Seneca County,Seneca County,NY,3,4,3,1,1,4,16
NY - Tioga County,Tioga County,NY,3,4,3,1,1,4,16
NY - Warren County,Warren County,NY,3,4,3,1,1,4,16
NY - Washington County,Washington County,NY,3,4,3,1,1,4,16
NY - Yates County,Yates County,NY,3,4,3,1,1,4,16
NY - New York County,New York County,NY,3,4,1,4,1,5,18
NY - Broome County,Broome County,NY,3,2,3,1,1,4,14
NY - Cattaraugus County,Cattaraugus County,NY,3,2,3,1,1,4,14
NY - Chenango County,Chenango County,NY,3,2,3,1,1,4,14
NY - Clinton County,Clinton County,NY,3,2,3,1,1,4,14
NY - Cortland County,Cortland County,NY,3,2,3,1,1,4,14
NY - Delaware County,Delaware County,NY,3,2,3,1,1,4,14
NY - Essex County,Essex County,NY,3,2,3,1,1,4,14
NY - Franklin County,Franklin County,NY,3,2,3,1,1,4,14
NY - Fulton County,Fulton County,NY,3,2,3,1,1,4,14
NY - Herkimer County,Herkimer County,NY,3,2,3,1,1,4,14
NY - Jefferson County,Jefferson County,NY,3,2,3,1,1,4,14
NY - Madison County,Madison County,NY,3,2,3,1,1,4,14
NY - Montgomery County,Montgomery County,NY,3,2,3,1,1,4,14
NY - Nassau County,Nassau County,NY,3,4,1,4,1,4,17
NY - Niagara County,Niagara County,NY,3,2,3,1,1,4,14
NY - Oneida County,Oneida County,NY,3,2,3,1,1,4,14
NY - Orleans County,Orleans County,NY,3,2,3,1,1,4,14
NY - Otsego County,Otsego County,NY,3,2,3,1,1,4,14
NY - Schoharie County,Schoharie County,NY,3,2,3,1,1,4,14
NY - Schuyler County,Schuyler County,NY,3,2,3,1,1,4,14
NY - Steuben County,Steuben County,NY,3,2,3,1,1,4,14
NY - Sullivan County,Sullivan County,NY,3,2,3,1,1,4,14
NY - Tompkins County,Tompkins County,NY,3,2,3,1,1,4,14
NY - Wyoming County,Wyoming County,NY,3,2,3,1,1,4,14
NY - Putnam County,Putnam County,NY,3,4,1,3,1,4,16
NY - Rockland County,Rockland County,NY,3,4,1,3,1,4,16
NY - Hamilton County,Hamilton County,NY,3,2,1,1,1,2,10
OH - Gallia County,Gallia County,OH,6,7,3,1,2,5,24
OH - Meigs County,Meigs County,OH,6,7,3,1,2,5,24
OH - Montgomery County,Montgomery County,OH,6,6,3,1,1,5,22
OH - Noble County,Noble County,OH,4,5,4,1,2,5,21
OH - Guernsey County,Guernsey County,OH,4,5,3,1,2,5,20
OH - Scioto County,Scioto County,OH,4,5,3,1,2,5,20
OH - Warren County,Warren County,OH,6,5,3,1,1,5,21
OH - Fairfield County,Fairfield County,OH,4,5,3,1,1,5,19
OH - Hamilton County,Hamilton County,OH,4,5,3,1,1,5,19
OH - Jackson County,Jackson County,OH,4,4,3,1,2,5,19
OH - Pike County,Pike County,OH,4,4,3,1,2,5,19
OH - Putnam County,Putnam County,OH,4,5,3,1,1,5,19
OH - Ross County,Ross County,OH,4,4,3,1,2,5,19
OH - Van Wert County,Van Wert County,OH,4,5,3,1,1,5,19
OH - Vinton County,Vinton County,OH,4,4,3,1,2,5,19
OH - Washington County,Washington County,OH,4,4,3,1,2,5,19
OH - Brown County,Brown County,OH,4,4,3,1,1,5,18
OH - Butler County,Butler County,OH,4,4,3,1,1,5,18
OH - Champaign County,Champaign County,OH,4,4,3,1,1,5,18
OH - Coshocton County,Coshocton County,OH,3,4,3,1,2,5,18
OH - Defiance County,Defiance County,OH,4,5,3,1,1,4,18
OH - Delaware County,Delaware County,OH,4,4,3,1,1,5,18
OH - Franklin County,Franklin County,OH,4,4,3,1,1,5,18
OH - Hardin County,Hardin County,OH,4,4,3,1,1,5,18
OH - Harrison County,Harrison County,OH,3,4,3,1,2,5,18
OH - Lawrence County,Lawrence County,OH,3,4,3,1,2,5,18
OH - Lucas County,Lucas County,OH,4,5,3,1,1,4,18
OH - Madison County,Madison County,OH,4,4,3,1,1,5,18
OH - Marion County,Marion County,OH,4,4,3,1,1,5,18
OH - Morgan County,Morgan County,OH,3,4,3,1,2,5,18
OH - Muskingum County,Muskingum County,OH,3,4,3,1,2,5,18
OH - Paulding County,Paulding County,OH,4,4,3,1,1,5,18
OH - Pickaway County,Pickaway County,OH,4,4,3,1,1,5,18
OH - Sandusky County,Sandusky County,OH,4,5,3,1,1,4,18
OH - Seneca County,Seneca County,OH,4,5,3,1,1,4,18
OH - Shelby County,Shelby County,OH,4,4,3,1,1,5,18
OH - Tuscarawas County,Tuscarawas County,OH,3,4,3,1,2,5,18
OH - Union County,Union County,OH,4,4,3,1,1,5,18
OH - Wood County,Wood County,OH,4,5,3,1,1,4,18
OH - Wyandot County,Wyandot County,OH,4,4,3,1,1,5,18
OH - Adams County,Adams County,OH,3,4,3,1,1,5,17
OH - Athens County,Athens County,OH,3,2,3,1,2,5,16
OH - Auglaize County,Auglaize County,OH,3,4,3,1,1,5,17
OH - Belmont County,Belmont County,OH,3,4,3,1,2,4,17
OH - Carroll County,Carroll County,OH,3,2,3,1,2,5,16
OH - Clark County,Clark County,OH,4,2,3,1,1,5,16
OH - Clermont County,Clermont County,OH,4,2,3,1,1,5,16
OH - Clinton County,Clinton County,OH,3,4,3,1,1,5,17
OH - Darke County,Darke County,OH,3,4,3,1,1,5,17
OH - Fayette County,Fayette County,OH,3,4,3,1,1,5,17
OH - Greene County,Greene County,OH,3,4,3,1,1,5,17
OH - Hancock County,Hancock County,OH,4,4,3,1,1,4,17
OH - Henry County,Henry County,OH,3,4,3,1,1,5,17
OH - Highland County,Highland County,OH,3,4,3,1,1,5,17
OH - Hocking County,Hocking County,OH,3,4,3,1,1,5,17
OH - Huron County,Huron County,OH,3,5,3,1,1,4,17
OH - Jefferson County,Jefferson County,OH,3,4,3,1,2,4,17
OH - Licking County,Licking County,OH,3,4,3,1,1,5,17
OH - Logan County,Logan County,OH,3,4,3,1,1,5,17
OH - Mercer County,Mercer County,OH,3,4,3,1,1,5,17
OH - Monroe County,Monroe County,OH,3,2,3,1,2,5,16
OH - Morrow County,Morrow County,OH,3,4,3,1,1,5,17
OH - Ottawa County,Ottawa County,OH,3,5,3,1,1,4,17
OH - Perry County,Perry County,OH,3,4,3,1,1,5,17
OH - Preble County,Preble County,OH,4,2,3,1,1,5,16
OH - Williams County,Williams County,OH,4,4,3,1,1,4,17
OH - Allen County,Allen County,OH,3,4,3,1,1,4,16
OH - Ashtabula County,Ashtabula County,OH,3,4,3,1,1,4,16
OH - Columbiana County,Columbiana County,OH,3,4,3,1,1,4,16
OH - Crawford County,Crawford County,OH,3,2,3,1,1,5,15
OH - Cuyahoga County,Cuyahoga County,OH,3,5,3,1,1,4,17
OH - Fulton County,Fulton County,OH,3,4,3,1,1,4,16
OH - Geauga County,Geauga County,OH,3,4,3,1,1,4,16
OH - Holmes County,Holmes County,OH,3,1,3,1,2,5,15
OH - Knox County,Knox County,OH,3,2,3,1,1,5,15
OH - Lake County,Lake County,OH,3,4,3,1,1,4,16
OH - Lorain County,Lorain County,OH,3,4,3,1,1,4,16
OH - Mahoning County,Mahoning County,OH,3,4,3,1,1,4,16
OH - Medina County,Medina County,OH,3,4,3,1,1,4,16
OH - Miami County,Miami County,OH,3,2,3,1,1,5,15
OH - Stark County,Stark County,OH,3,4,3,1,1,4,16
OH - Summit County,Summit County,OH,3,4,3,1,1,4,16
OH - Trumbull County,Trumbull County,OH,3,4,3,1,1,4,16
OH - Wayne County,Wayne County,OH,3,4,3,1,1,4,16
OH - Ashland County,Ashland County,OH,3,2,3,1,1,4,14
OH - Erie County,Erie County,OH,3,2,3,1,1,4,14
OH - Portage County,Portage County,OH,3,2,3,1,1,4,14
OH - Richland County,Richland County,OH,3,2,3,1,1,4,14
OK - Grady County,Grady County,OK,9,4,10,1,1,4,29
OK - Harmon County,Harmon County,OK,9,2,10,1,2,4,28
OK - Jefferson County,Jefferson County,OK,9,4,10,1,1,4,29
OK - Kiowa County,Kiowa County,OK,9,4,10,1,1,4,29
OK - Le Flore County,Le Flore County,OK,7,4,9,1,3,4,28
OK - Okmulgee County,Okmulgee County,OK,7,4,9,1,3,4,28
OK - Pittsburg County,Pittsburg County,OK,7,4,9,1,3,4,28
OK - Pottawatomie County,Pottawatomie County,OK,9,4,9,1,2,4,29
OK - Seminole County,Seminole County,OK,9,4,9,1,2,4,29
OK - Tillman County,Tillman County,OK,7,4,10,1,2,4,28
OK - Washita County,Washita County,OK,9,4,10,1,1,4,29
OK - Woodward County,Woodward County,OK,7,4,9,1,3,4,28
OK - Alfalfa County,Alfalfa County,OK,9,4,9,1,1,4,28
OK - Atoka County,Atoka County,OK,7,4,9,1,2,4,27
OK - Choctaw County,Choctaw County,OK,9,4,9,1,1,4,28
OK - Cleveland County,Cleveland County,OK,7,4,9,1,2,4,27
OK - Comanche County,Comanche County,OK,7,4,10,1,1,4,27
OK - Ellis County,Ellis County,OK,7,2,9,1,3,4,26
OK - Garvin County,Garvin County,OK,7,4,10,1,1,4,27
OK - Hughes County,Hughes County,OK,7,4,9,1,2,4,27
OK - McIntosh County,McIntosh County,OK,7,4,9,1,2,4,27
OK - Murray County,Murray County,OK,7,4,10,1,1,4,27
OK - Okfuskee County,Okfuskee County,OK,7,4,9,1,2,4,27
OK - Osage County,Osage County,OK,7,4,8,1,3,4,27
OK - Pawnee County,Pawnee County,OK,7,4,9,1,2,4,27
OK - Tulsa County,Tulsa County,OK,7,4,9,1,2,4,27
OK - Beaver County,Beaver County,OK,7,2,8,1,3,4,25
OK - Beckham County,Beckham County,OK,7,2,9,1,2,4,25
OK - Bryan County,Bryan County,OK,7,4,9,1,1,4,26
OK - Canadian County,Canadian County,OK,7,4,9,1,1,4,26
OK - Coal County,Coal County,OK,7,2,9,1,2,4,25
OK - Dewey County,Dewey County,OK,7,2,9,1,2,4,25
OK - Garfield County,Garfield County,OK,7,4,9,1,1,4,26
OK - Harper County,Harper County,OK,7,2,9,1,2,4,25
OK - Haskell County,Haskell County,OK,7,4,8,1,2,4,26
OK - Kingfisher County,Kingfisher County,OK,7,4,9,1,1,4,26
OK - Logan County,Logan County,OK,7,4,9,1,1,4,26
OK - Love County,Love County,OK,7,2,10,1,1,4,25
OK - McClain County,McClain County,OK,7,2,10,1,1,4,25
OK - Major County,Major County,OK,7,4,9,1,1,4,26
OK - Muskogee County,Muskogee County,OK,7,4,9,1,1,4,26
OK - Noble County,Noble County,OK,7,4,9,1,1,4,26
OK - Oklahoma County,Oklahoma County,OK,7,4,9,1,1,4,26
OK - Pontotoc County,Pontotoc County,OK,7,2,9,1,2,4,25
OK - Roger Mills County,Roger Mills County,OK,7,2,9,1,2,4,25
OK - Rogers County,Rogers County,OK,7,2,8,1,3,4,25
OK - Stephens County,Stephens County,OK,7,2,10,1,1,4,25
OK - Wagoner County,Wagoner County,OK,7,4,8,1,2,4,26
OK - Blaine County,Blaine County,OK,7,2,9,1,1,4,24
OK - Caddo County,Caddo County,OK,7,2,9,1,1,4,24
OK - Carter County,Carter County,OK,7,2,9,1,1,4,24
OK - Craig County,Craig County,OK,6,4,8,1,2,4,25
OK - Creek County,Creek County,OK,6,2,9,1,2,4,24
OK - Custer County,Custer County,OK,7,2,9,1,1,4,24
OK - Grant County,Grant County,OK,7,2,9,1,1,4,24
OK - Lincoln County,Lincoln County,OK,7,2,9,1,1,4,24
OK - McCurtain County,McCurtain County,OK,7,2,9,1,1,4,24
OK - Mayes County,Mayes County,OK,6,4,8,1,2,4,25
OK - Nowata County,Nowata County,OK,7,2,8,1,2,4,24
OK - Ottawa County,Ottawa County,OK,6,4,8,1,2,4,25
OK - Payne County,Payne County,OK,7,2,9,1,1,4,24
OK - Texas County,Texas County,OK,7,2,8,1,3,4,25
OK - Washington County,Washington County,OK,7,2,8,1,2,4,24
OK - Delaware County,Delaware County,OK,6,2,8,1,2,4,23
OK - Kay County,Kay County,OK,7,2,8,1,1,4,23
OK - Sequoyah County,Sequoyah County,OK,6,2,8,1,2,4,23
OK - Cimarron County,Cimarron County,OK,7,1,5,1,3,4,21
OK - Greer County,Greer County,OK,9,4,1,1,2,4,21
OK - Jackson County,Jackson County,OK,9,4,1,1,2,4,21
OK - Johnston County,Johnston County,OK,9,4,1,1,2,4,21
OK - Cherokee County,Cherokee County,OK,7,4,1,1,2,4,19
OK - Cotton County,Cotton County,OK,9,4,1,1,1,4,20
OK - Marshall County,Marshall County,OK,9,4,1,1,1,4,20
OK - Pushmataha County,Pushmataha County,OK,7,2,1,1,3,4,18
OK - Woods County,Woods County,OK,9,4,1,1,1,4,20
OK - Latimer County,Latimer County,OK,7,2,1,1,2,4,17
OK - Adair County,Adair County,OK,6,2,1,1,2,4,16
OR - Malheur County,Malheur County,OR,6,1,5,1,10,4,27
OR - Morrow County,Morrow County,OR,4,1,5,1,9,5,25
OR - Grant County,Grant County,OR,6,1,4,1,9,4,25
OR - Umatilla County,Umatilla County,OR,6,1,5,1,7,5,25
OR - Baker County,Baker County,OR,4,1,4,1,9,4,23
OR - Jackson County,Jackson County,OR,4,1,4,1,8,5,23
OR - Josephine County,Josephine County,OR,7,1,3,1,7,5,24
OR - Gilliam County,Gilliam County,OR,4,1,4,1,8,4,22
OR - Wallowa County,Wallowa County,OR,4,1,3,1,9,4,22
OR - Union County,Union County,OR,4,1,4,1,7,4,21
OR - Harney County,Harney County,OR,4,1,1,1,10,4,21
OR - Lake County,Lake County,OR,6,1,1,1,9,4,22
OR - Douglas County,Douglas County,OR,4,2,1,3,7,4,21
OR - Lane County,Lane County,OR,3,1,3,3,6,5,21
OR - Deschutes County,Deschutes County,OR,3,1,3,1,6,4,18
OR - Klamath County,Klamath County,OR,4,1,1,1,8,4,19
OR - Wasco County,Wasco County,OR,6,1,1,1,7,4,20
OR - Clackamas County,Clackamas County,OR,3,1,3,1,5,5,18
OR - Crook County,Crook County,OR,4,1,1,1,7,4,18
OR - Sherman County,Sherman County,OR,4,1,1,1,6,5,18
OR - Wheeler County,Wheeler County,OR,4,1,1,1,7,4,18
OR - Jefferson County,Jefferson County,OR,4,1,1,1,6,4,17
OR - Multnomah County,Multnomah County,OR,3,4,3,3,1,5,19
OR - Yamhill County,Yamhill County,OR,4,2,3,1,1,4,15
OR - Hood River County,Hood River County,OR,4,1,1,1,4,4,15
OR - Linn County,Linn County,OR,3,1,3,1,1,5,14
OR - Marion County,Marion County,OR,3,1,3,1,1,5,14
OR - Washington County,Washington County,OR,3,2,3,1,1,4,14
OR - Polk County,Polk County,OR,3,1,3,1,1,4,13
OR - Clatsop County,Clatsop County,OR,3,1,1,4,1,4,14
OR - Coos County,Coos County,OR,3,2,1,3,1,4,14
OR - Lincoln County,Lincoln County,OR,3,1,1,4,1,4,14
OR - Tillamook County,Tillamook County,OR,3,1,1,4,1,4,14
OR - Benton County,Benton County,OR,3,2,1,1,1,4,12
OR - Columbia County,Columbia County,OR,3,1,1,3,1,4,13
OR - Curry County,Curry County,OR,1,1,1,3,1,4,11
PA - Montgomery County,Montgomery County,PA,4,5,4,1,1,5,20
PA - Berks County,Berks County,PA,4,4,3,1,2,5,19
PA - Bucks County,Bucks County,PA,3,5,3,3,1,5,20
PA - Cumberland County,Cumberland County,PA,4,4,3,1,2,4,18
PA - Greene County,Greene County,PA,3,4,3,1,2,5,18
PA - Juniata County,Juniata County,PA,4,2,3,1,2,5,17
PA - Perry County,Perry County,PA,4,2,3,1,2,5,17
PA - Allegheny County,Allegheny County,PA,3,4,3,1,2,4,17
PA - Armstrong County,Armstrong County,PA,3,4,3,1,2,4,17
PA - Beaver County,Beaver County,PA,3,4,3,1,2,4,17
PA - Butler County,Butler County,PA,3,4,3,1,2,4,17
PA - Centre County,Centre County,PA,3,4,3,1,2,4,17
PA - Chester County,Chester County,PA,3,4,3,1,1,5,17
PA - Clinton County,Clinton County,PA,3,4,3,1,2,4,17
PA - Delaware County,Delaware County,PA,4,5,1,3,1,5,19
PA - Fayette County,Fayette County,PA,3,4,3,1,2,4,17
PA - Franklin County,Franklin County,PA,4,2,3,1,2,4,16
PA - Jefferson County,Jefferson County,PA,3,4,3,1,2,4,17
PA - Lackawanna County,Lackawanna County,PA,3,4,3,1,2,4,17
PA - Lancaster County,Lancaster County,PA,4,1,4,1,1,5,16
PA - Lawrence County,Lawrence County,PA,3,4,3,1,2,4,17
PA - Luzerne County,Luzerne County,PA,3,4,3,1,2,4,17
PA - Mifflin County,Mifflin County,PA,4,2,3,1,2,4,16
PA - Schuylkill County,Schuylkill County,PA,4,2,3,1,2,4,16
PA - Washington County,Washington County,PA,3,4,3,1,2,4,17
PA - Westmoreland County,Westmoreland County,PA,3,4,3,1,2,4,17
PA - Adams County,Adams County,PA,4,2,3,1,1,4,15
PA - Blair County,Blair County,PA,3,2,3,1,2,4,15
PA - Bradford County,Bradford County,PA,3,4,3,1,1,4,16
PA - Cambria County,Cambria County,PA,3,2,3,1,2,4,15
PA - Cameron County,Cameron County,PA,3,4,3,1,1,4,16
PA - Carbon County,Carbon County,PA,3,4,3,1,1,4,16
PA - Clarion County,Clarion County,PA,3,2,3,1,2,4,15
PA - Clearfield County,Clearfield County,PA,3,2,3,1,2,4,15
PA - Crawford County,Crawford County,PA,3,4,3,1,1,4,16
PA - Forest County,Forest County,PA,3,4,3,1,1,4,16
PA - Huntingdon County,Huntingdon County,PA,3,2,3,1,2,4,15
PA - Indiana County,Indiana County,PA,3,2,3,1,2,4,15
PA - Lebanon County,Lebanon County,PA,3,1,3,1,2,5,15
PA - Lehigh County,Lehigh County,PA,3,4,3,1,1,4,16
PA - Lycoming County,Lycoming County,PA,3,4,3,1,1,4,16
PA - Mercer County,Mercer County,PA,3,4,3,1,1,4,16
PA - Monroe County,Monroe County,PA,3,4,3,1,1,4,16
PA - Northampton County,Northampton County,PA,3,4,3,1,1,4,16
PA - Philadelphia County,Philadelphia County,PA,4,4,1,3,1,5,18
PA - Potter County,Potter County,PA,3,4,3,1,1,4,16
PA - Somerset County,Somerset County,PA,3,2,3,1,2,4,15
PA - Venango County,Venango County,PA,3,4,3,1,1,4,16
PA - Warren County,Warren County,PA,3,4,3,1,1,4,16
PA - Wayne County,Wayne County,PA,3,2,3,1,2,4,15
PA - Wyoming County,Wyoming County,PA,3,4,3,1,1,4,16
PA - Bedford County,Bedford County,PA,3,1,3,1,2,4,14
PA - Columbia County,Columbia County,PA,3,1,3,1,2,4,14
PA - Dauphin County,Dauphin County,PA,3,1,3,1,2,4,14
PA - Elk County,Elk County,PA,3,2,3,1,1,4,14
PA - Fulton County,Fulton County,PA,3,1,3,1,2,4,14
PA - McKean County,McKean County,PA,3,2,3,1,1,4,14
PA - Montour County,Montour County,PA,3,1,3,1,2,4,14
PA - Northumberland County,Northumberland County,PA,3,1,3,1,2,4,14
PA - Pike County,Pike County,PA,3,2,3,1,1,4,14
PA - Snyder County,Snyder County,PA,3,1,3,1,2,4,14
PA - Sullivan County,Sullivan County,PA,3,2,3,1,1,4,14
PA - Susquehanna County,Susquehanna County,PA,3,2,3,1,1,4,14
PA - Tioga County,Tioga County,PA,3,2,3,1,1,4,14
PA - Union County,Union County,PA,3,1,3,1,2,4,14
PA - York County,York County,PA,4,1,3,1,1,4,14
PA - Erie County,Erie County,PA,3,1,3,1,1,4,13
RI - Bristol County,Bristol County,RI,3,4,1,4,1,5,18
RI - Kent County,Kent County,RI,3,4,1,4,1,4,17
RI - Newport County,Newport County,RI,3,4,1,4,1,4,17
RI - Washington County,Washington County,RI,3,2,1,4,1,4,15
RI - Providence County,Providence County,RI,3,1,1,3,1,4,13
SC - Beaufort County,Beaufort County,SC,6,9,8,7,3,9,42
SC - Colleton County,Colleton County,SC,6,9,8,6,3,8,40
SC - Jasper County,Jasper County,SC,6,9,8,4,3,8,38
SC - Charleston County,Charleston County,SC,3,7,8,7,3,8,36
SC - Horry County,Horry County,SC,4,6,8,4,3,8,33
SC - Georgetown County,Georgetown County,SC,4,6,8,4,2,8,32
SC - Hampton County,Hampton County,SC,7,4,8,3,3,7,32
SC - Berkeley County,Berkeley County,SC,6,4,8,4,3,6,31
SC - Dorchester County,Dorchester County,SC,6,4,8,3,3,7,31
SC - Williamsburg County,Williamsburg County,SC,4,2,8,3,3,7,27
SC - Allendale County,Allendale County,SC,7,4,8,1,3,5,28
SC - Marion County,Marion County,SC,6,4,8,1,3,6,28
SC - Clarendon County,Clarendon County,SC,6,4,8,1,3,5,27
SC - Florence County,Florence County,SC,6,4,8,1,3,5,27
SC - Bamberg County,Bamberg County,SC,7,2,8,1,1,6,25
SC - Orangeburg County,Orangeburg County,SC,6,2,8,1,3,5,25
SC - Richland County,Richland County,SC,9,2,8,1,1,5,26
SC - Barnwell County,Barnwell County,SC,7,2,8,1,1,5,24
SC - Darlington County,Darlington County,SC,6,4,8,1,1,5,25
SC - Edgefield County,Edgefield County,SC,7,2,8,1,1,5,24
SC - Lexington County,Lexington County,SC,7,2,8,1,1,5,24
SC - McCormick County,McCormick County,SC,7,2,8,1,1,5,24
SC - Saluda County,Saluda County,SC,7,2,8,1,1,5,24
SC - Sumter County,Sumter County,SC,6,1,8,1,3,5,24
SC - Aiken County,Aiken County,SC,6,2,8,1,1,5,23
SC - Dillon County,Dillon County,SC,6,2,8,1,1,5,23
SC - Fairfield County,Fairfield County,SC,6,2,8,1,1,5,23
SC - Kershaw County,Kershaw County,SC,6,2,8,1,1,5,23
SC - Lee County,Lee County,SC,6,1,8,1,2,6,24
SC - Marlboro County,Marlboro County,SC,6,2,8,1,1,5,23
SC - Calhoun County,Calhoun County,SC,6,1,8,1,1,5,22
SC - Greenwood County,Greenwood County,SC,6,1,8,1,1,5,22
SC - Union County,Union County,SC,6,1,8,1,1,5,22
SC - Chesterfield County,Chesterfield County,SC,6,1,8,1,1,5,22
SC - Lancaster County,Lancaster County,SC,6,1,8,1,1,5,22
SC - Abbeville County,Abbeville County,SC,6,1,7,1,1,5,21
SC - Chester County,Chester County,SC,6,1,7,1,1,5,21
SC - Newberry County,Newberry County,SC,4,1,8,1,1,5,20
SC - Greenville County,Greenville County,SC,6,1,5,1,2,5,20
SC - Pickens County,Pickens County,SC,6,2,4,1,2,5,20
SC - Spartanburg County,Spartanburg County,SC,6,1,6,1,1,5,20
SC - York County,York County,SC,6,1,6,1,1,5,20
SC - Anderson County,Anderson County,SC,6,2,4,1,1,5,19
SC - Laurens County,Laurens County,SC,6,1,5,1,1,5,19
SC - Cherokee County,Cherokee County,SC,4,1,3,1,1,5,15
SC - Oconee County,Oconee County,SC,4,1,3,1,1,5,15
SD - Meade County,Meade County,SD,6,2,4,1,6,5,24
SD - Pennington County,Pennington County,SD,6,1,4,1,6,5,23
SD - Haakon County,Haakon County,SD,6,2,5,1,4,5,23
SD - Butte County,Butte County,SD,4,1,4,1,6,5,21
SD - Harding County,Harding County,SD,4,1,4,1,6,5,21
SD - Jackson County,Jackson County,SD,6,2,5,1,3,5,22
SD - Jones County,Jones County,SD,6,2,5,1,3,5,22
SD - Lyman County,Lyman County,SD,6,2,6,1,2,5,22
SD - Perkins County,Perkins County,SD,4,2,3,1,6,5,21
SD - Ziebach County,Ziebach County,SD,6,2,4,1,4,5,22
SD - Charles Mix County,Charles Mix County,SD,6,2,5,1,2,5,21
SD - Custer County,Custer County,SD,3,1,4,1,6,5,20
SD - Dewey County,Dewey County,SD,4,2,4,1,4,5,20
SD - Mellette County,Mellette County,SD,6,2,5,1,2,5,21
SD - Bennett County,Bennett County,SD,6,2,4,1,2,5,20
SD - Brule County,Brule County,SD,6,2,5,1,1,5,20
SD - Corson County,Corson County,SD,4,2,4,1,4,4,19
SD - Douglas County,Douglas County,SD,6,2,5,1,1,5,20
SD - Fall River County,Fall River County,SD,6,1,4,1,3,5,20
SD - Gregory County,Gregory County,SD,4,2,5,1,2,5,19
SD - Hughes County,Hughes County,SD,6,2,4,1,2,5,20
SD - Stanley County,Stanley County,SD,6,2,3,1,3,5,20
SD - Sully County,Sully County,SD,6,2,4,1,2,5,20
SD - Tripp County,Tripp County,SD,6,2,5,1,1,5,20
SD - Yankton County,Yankton County,SD,6,2,5,1,1,5,20
SD - Bon Homme County,Bon Homme County,SD,4,2,5,1,1,5,18
SD - Faulk County,Faulk County,SD,4,2,4,1,2,5,18
SD - Hand County,Hand County,SD,4,2,4,1,2,5,18
SD - Hyde County,Hyde County,SD,4,2,4,1,2,5,18
SD - Lawrence County,Lawrence County,SD,3,1,4,1,5,4,18
SD - Potter County,Potter County,SD,6,2,3,1,2,5,19
SD - Sanborn County,Sanborn County,SD,4,2,5,1,1,5,18
SD - Beadle County,Beadle County,SD,4,2,4,1,1,5,17
SD - Buffalo County,Buffalo County,SD,4,1,5,1,1,5,17
SD - Clay County,Clay County,SD,4,1,5,1,1,5,17
SD - Davison County,Davison County,SD,4,2,4,1,1,5,17
SD - Hanson County,Hanson County,SD,4,2,4,1,1,5,17
SD - Jerauld County,Jerauld County,SD,4,2,4,1,1,5,17
SD - Todd County,Todd County,SD,6,2,3,1,1,5,18
SD - Aurora County,Aurora County,SD,4,1,4,1,1,5,16
SD - Campbell County,Campbell County,SD,4,2,3,1,1,5,16
SD - Hutchinson County,Hutchinson County,SD,4,1,4,1,1,5,16
SD - Lincoln County,Lincoln County,SD,4,1,4,1,1,5,16
SD - McCook County,McCook County,SD,4,1,4,1,1,5,16
SD - McPherson County,McPherson County,SD,4,2,3,1,1,5,16
SD - Marshall County,Marshall County,SD,4,2,3,1,1,5,16
SD - Miner County,Miner County,SD,3,2,4,1,1,5,16
SD - Oglala Lakota County,Oglala Lakota County,SD,1,1,4,1,3,5,15
SD - Roberts County,Roberts County,SD,4,2,3,1,1,5,16
SD - Spink County,Spink County,SD,4,1,4,1,1,5,16
SD - Turner County,Turner County,SD,4,1,4,1,1,5,16
SD - Union County,Union County,SD,4,1,4,1,1,5,16
SD - Walworth County,Walworth County,SD,4,2,3,1,1,5,16
SD - Brown County,Brown County,SD,4,1,3,1,1,5,15
SD - Edmunds County,Edmunds County,SD,4,1,3,1,1,5,15
SD - Kingsbury County,Kingsbury County,SD,3,2,3,1,1,5,15
SD - Minnehaha County,Minnehaha County,SD,4,1,3,1,1,5,15
SD - Brookings County,Brookings County,SD,3,1,3,1,1,5,14
SD - Clark County,Clark County,SD,3,1,3,1,1,5,14
SD - Codington County,Codington County,SD,3,1,3,1,1,5,14
SD - Day County,Day County,SD,3,1,3,1,1,5,14
SD - Deuel County,Deuel County,SD,3,1,3,1,1,5,14
SD - Grant County,Grant County,SD,3,1,3,1,1,5,14
SD - Hamlin County,Hamlin County,SD,3,1,3,1,1,5,14
SD - Lake County,Lake County,SD,3,1,3,1,1,5,14
SD - Moody County,Moody County,SD,3,1,3,1,1,5,14
TN - Shelby County,Shelby County,TN,7,7,8,1,1,5,29
TN - Dyer County,Dyer County,TN,6,7,8,1,1,5,28
TN - Lake County,Lake County,TN,6,7,8,1,1,5,28
TN - Madison County,Madison County,TN,6,7,8,1,1,5,28
TN - Tipton County,Tipton County,TN,6,7,8,1,1,5,28
TN - Chester County,Chester County,TN,6,7,8,1,1,5,28
TN - Crockett County,Crockett County,TN,6,7,8,1,1,5,28
TN - Fayette County,Fayette County,TN,7,5,8,1,1,5,27
TN - Gibson County,Gibson County,TN,6,7,8,1,1,5,28
TN - Haywood County,Haywood County,TN,6,7,8,1,1,5,28
TN - Henderson County,Henderson County,TN,6,7,8,1,1,5,28
TN - Lauderdale County,Lauderdale County,TN,6,6,8,1,1,5,27
TN - McNairy County,McNairy County,TN,6,6,8,1,1,5,27
TN - Montgomery County,Montgomery County,TN,6,7,8,1,1,5,28
TN - Obion County,Obion County,TN,6,7,8,1,1,5,28
TN - Weakley County,Weakley County,TN,6,7,8,1,1,5,28
TN - Carroll County,Carroll County,TN,6,6,8,1,1,5,27
TN - Hardeman County,Hardeman County,TN,6,5,8,1,1,5,26
TN - Hardin County,Hardin County,TN,6,6,8,1,1,5,27
TN - Stewart County,Stewart County,TN,6,7,7,1,1,5,27
TN - Benton County,Benton County,TN,6,6,7,1,1,5,26
TN - Henry County,Henry County,TN,6,6,7,1,1,5,26
TN - Perry County,Perry County,TN,6,4,8,1,1,5,25
TN - Cheatham County,Cheatham County,TN,6,5,7,1,1,5,25
TN - Decatur County,Decatur County,TN,6,4,7,1,1,5,24
TN - Houston County,Houston County,TN,6,5,6,1,1,5,24
TN - Humphreys County,Humphreys County,TN,4,5,7,1,1,5,23
TN - Macon County,Macon County,TN,6,7,4,1,1,5,24
TN - Maury County,Maury County,TN,6,4,7,1,1,5,24
TN - Trousdale County,Trousdale County,TN,6,7,4,1,1,5,24
TN - Giles County,Giles County,TN,6,4,6,1,1,5,23
TN - Hamilton County,Hamilton County,TN,6,2,6,1,2,5,22
TN - Hickman County,Hickman County,TN,4,4,7,1,1,5,22
TN - Robertson County,Robertson County,TN,6,5,5,1,1,5,23
TN - Rutherford County,Rutherford County,TN,6,4,6,1,1,5,23
TN - Sumner County,Sumner County,TN,6,5,5,1,1,5,23
TN - Williamson County,Williamson County,TN,6,5,5,1,1,5,23
TN - Davidson County,Davidson County,TN,6,5,4,1,1,5,22
TN - Dickson County,Dickson County,TN,4,4,6,1,1,5,21
TN - Jackson County,Jackson County,TN,6,5,4,1,1,5,22
TN - Lincoln County,Lincoln County,TN,6,4,5,1,1,5,22
TN - Roane County,Roane County,TN,4,4,5,1,2,5,21
TN - Smith County,Smith County,TN,6,6,3,1,1,5,22
TN - Wayne County,Wayne County,TN,6,2,6,1,1,5,21
TN - Wilson County,Wilson County,TN,6,5,4,1,1,5,22
TN - Anderson County,Anderson County,TN,4,2,5,1,2,5,19
TN - Bedford County,Bedford County,TN,6,4,4,1,1,5,21
TN - Cannon County,Cannon County,TN,6,4,4,1,1,5,21
TN - Lawrence County,Lawrence County,TN,4,2,6,1,1,5,19
TN - Lewis County,Lewis County,TN,4,2,6,1,1,5,19
TN - Marshall County,Marshall County,TN,6,4,4,1,1,5,21
TN - Sevier County,Sevier County,TN,3,1,7,1,2,5,19
TN - Clay County,Clay County,TN,4,4,4,1,1,5,19
TN - Grundy County,Grundy County,TN,6,2,3,1,2,5,19
TN - Knox County,Knox County,TN,4,2,4,1,2,5,18
TN - Loudon County,Loudon County,TN,4,4,3,1,2,5,19
TN - Marion County,Marion County,TN,6,2,3,1,2,5,19
TN - Moore County,Moore County,TN,4,2,5,1,1,5,18
TN - Scott County,Scott County,TN,4,2,4,1,2,5,18
TN - Warren County,Warren County,TN,6,4,3,1,1,5,20
TN - White County,White County,TN,4,4,3,1,2,5,19
TN - Bledsoe County,Bledsoe County,TN,4,2,3,1,2,5,17
TN - Campbell County,Campbell County,TN,4,1,4,1,2,5,17
TN - Claiborne County,Claiborne County,TN,4,2,3,1,2,5,17
TN - Cocke County,Cocke County,TN,4,2,3,1,2,5,17
TN - Coffee County,Coffee County,TN,4,4,3,1,1,5,18
TN - DeKalb County,DeKalb County,TN,4,4,3,1,1,5,18
TN - Franklin County,Franklin County,TN,4,2,3,1,2,5,17
TN - Hamblen County,Hamblen County,TN,4,2,3,1,2,5,17
TN - Jefferson County,Jefferson County,TN,4,2,3,1,2,5,17
TN - McMinn County,McMinn County,TN,4,2,3,1,2,5,17
TN - Meigs County,Meigs County,TN,4,2,3,1,2,5,17
TN - Monroe County,Monroe County,TN,4,2,3,1,2,5,17
TN - Overton County,Overton County,TN,4,4,3,1,1,5,18
TN - Rhea County,Rhea County,TN,4,2,3,1,2,5,17
TN - Sequatchie County,Sequatchie County,TN,4,2,3,1,2,5,17
TN - Blount County,Blount County,TN,4,1,3,1,2,5,16
TN - Bradley County,Bradley County,TN,4,1,3,1,2,5,16
TN - Carter County,Carter County,TN,3,2,3,1,2,5,16
TN - Fentress County,Fentress County,TN,3,2,3,1,2,5,16
TN - Grainger County,Grainger County,TN,4,1,3,1,2,5,16
TN - Greene County,Greene County,TN,4,1,3,1,2,5,16
TN - Hancock County,Hancock County,TN,4,1,3,1,2,5,16
TN - Hawkins County,Hawkins County,TN,4,1,3,1,2,5,16
TN - Polk County,Polk County,TN,4,1,3,1,2,5,16
TN - Putnam County,Putnam County,TN,4,2,3,1,1,5,16
TN - Unicoi County,Unicoi County,TN,3,2,3,1,2,5,16
TN - Union County,Union County,TN,4,1,3,1,2,5,16
TN - Van Buren County,Van Buren County,TN,4,1,3,1,2,5,16
TN - Cumberland County,Cumberland County,TN,3,1,3,1,2,5,15
TN - Johnson County,Johnson County,TN,3,1,3,1,2,5,15
TN - Morgan County,Morgan County,TN,3,1,3,1,2,5,15
TN - Pickett County,Pickett County,TN,3,2,3,1,1,5,15
TN - Sullivan County,Sullivan County,TN,3,1,3,1,2,5,15
TN - Washington County,Washington County,TN,3,1,3,1,2,5,15
TX - Cameron County,Cameron County,TX,6,10,8,4,1,7,36
TX - Galveston County,Galveston County,TX,6,7,9,4,1,8,35
TX - Willacy County,Willacy County,TX,10,4,10,4,1,7,36
TX - Kleberg County,Kleberg County,TX,9,4,10,4,1,7,35
TX - Refugio County,Refugio County,TX,9,4,10,4,1,7,35
TX - Nueces County,Nueces County,TX,9,5,8,4,1,7,34
TX - Pecos County,Pecos County,TX,9,4,8,1,6,5,33
TX - Starr County,Starr County,TX,10,6,10,1,1,6,34
TX - Webb County,Webb County,TX,10,7,10,1,1,5,34
TX - Harris County,Harris County,TX,9,4,10,3,1,6,33
TX - Hidalgo County,Hidalgo County,TX,10,5,8,1,1,7,32
TX - Jasper County,Jasper County,TX,7,5,10,1,1,7,31
TX - Live Oak County,Live Oak County,TX,9,4,10,1,1,7,32
TX - San Patricio County,San Patricio County,TX,9,4,8,4,1,7,33
TX - Waller County,Waller County,TX,9,4,10,1,1,7,32
TX - Bee County,Bee County,TX,9,4,9,1,1,7,31
TX - Brazoria County,Brazoria County,TX,4,4,10,4,1,7,30
TX - Brewster County,Brewster County,TX,9,2,8,1,6,5,31
TX - Dimmit County,Dimmit County,TX,10,5,10,1,1,5,32
TX - Goliad County,Goliad County,TX,9,4,10,1,1,6,31
TX - Grimes County,Grimes County,TX,9,4,10,1,2,6,32
TX - Llano County,Llano County,TX,10,4,10,1,2,5,32
TX - Montgomery County,Montgomery County,TX,9,4,10,1,1,6,31
TX - San Jacinto County,San Jacinto County,TX,7,2,10,1,1,8,29
TX - Tyler County,Tyler County,TX,7,2,10,1,1,8,29
TX - Zavala County,Zavala County,TX,10,5,10,1,1,5,32
TX - Aransas County,Aransas County,TX,9,10,1,6,1,8,35
TX - Atascosa County,Atascosa County,TX,10,4,10,1,1,5,31
TX - Bexar County,Bexar County,TX,9,4,10,1,2,5,31
TX - Callahan County,Callahan County,TX,9,4,10,1,2,5,31
TX - Chambers County,Chambers County,TX,6,4,8,4,1,8,31
TX - Coleman County,Coleman County,TX,9,4,10,1,2,5,31
TX - Colorado County,Colorado County,TX,9,4,10,1,1,6,31
TX - DeWitt County,DeWitt County,TX,10,4,10,1,1,5,31
TX - Fort Bend County,Fort Bend County,TX,9,2,9,1,1,7,29
TX - Haskell County,Haskell County,TX,9,4,10,1,2,5,31
TX - Jim Wells County,Jim Wells County,TX,9,4,9,1,1,6,30
TX - Kinney County,Kinney County,TX,10,5,9,1,1,5,31
TX - Lavaca County,Lavaca County,TX,9,4,10,1,2,5,31
TX - Liberty County,Liberty County,TX,7,2,8,3,1,8,29
TX - Limestone County,Limestone County,TX,9,4,10,1,2,5,31
TX - Reagan County,Reagan County,TX,10,4,8,1,3,5,31
TX - Wilbarger County,Wilbarger County,TX,9,4,10,1,2,5,31
TX - Wilson County,Wilson County,TX,9,4,10,1,1,6,31
TX - Austin County,Austin County,TX,9,4,10,1,1,5,30
TX - Bastrop County,Bastrop County,TX,9,4,10,1,1,5,30
TX - Borden County,Borden County,TX,9,4,8,1,3,5,30
TX - Bosque County,Bosque County,TX,9,4,10,1,1,5,30
TX - Brazos County,Brazos County,TX,9,4,10,1,1,5,30
TX - Caldwell County,Caldwell County,TX,9,4,9,1,2,5,30
TX - Calhoun County,Calhoun County,TX,4,4,8,4,1,7,28
TX - Collingsworth County,Collingsworth County,TX,9,4,8,1,3,5,30
TX - Comanche County,Comanche County,TX,9,4,10,1,1,5,30
TX - Concho County,Concho County,TX,9,2,10,1,2,5,29
TX - Coryell County,Coryell County,TX,9,4,10,1,1,5,30
TX - Dallas County,Dallas County,TX,9,4,10,1,1,5,30
TX - Denton County,Denton County,TX,9,4,10,1,1,5,30
TX - Erath County,Erath County,TX,9,4,10,1,1,5,30
TX - Fayette County,Fayette County,TX,9,4,10,1,1,5,30
TX - Freestone County,Freestone County,TX,9,4,10,1,1,5,30
TX - Gonzales County,Gonzales County,TX,9,4,10,1,1,5,30
TX - Hamilton County,Hamilton County,TX,9,4,10,1,1,5,30
TX - Hood County,Hood County,TX,9,4,10,1,1,5,30
TX - Jefferson County,Jefferson County,TX,6,9,3,4,1,8,31
TX - Johnson County,Johnson County,TX,9,4,10,1,1,5,30
TX - Jones County,Jones County,TX,9,4,9,1,2,5,30
TX - Karnes County,Karnes County,TX,9,4,10,1,1,5,30
TX - Kaufman County,Kaufman County,TX,9,4,10,1,1,5,30
TX - La Salle County,La Salle County,TX,10,2,10,1,1,5,29
TX - Lee County,Lee County,TX,9,4,10,1,1,5,30
TX - McCulloch County,McCulloch County,TX,9,2,10,1,2,5,29
TX - Medina County,Medina County,TX,9,4,8,1,2,6,30
TX - Navarro County,Navarro County,TX,9,4,10,1,1,5,30
TX - Rockwall County,Rockwall County,TX,9,4,10,1,1,5,30
TX - Runnels County,Runnels County,TX,9,4,9,1,2,5,30
TX - Shelby County,Shelby County,TX,9,4,10,1,1,5,30
TX - Tarrant County,Tarrant County,TX,9,4,10,1,1,5,30
TX - Taylor County,Taylor County,TX,9,4,9,1,2,5,30
TX - Throckmorton County,Throckmorton County,TX,9,4,10,1,1,5,30
TX - Tom Green County,Tom Green County,TX,9,4,8,1,3,5,30
TX - Van Zandt County,Van Zandt County,TX,9,4,10,1,1,5,30
TX - Walker County,Walker County,TX,9,2,10,1,1,6,29
TX - Wichita County,Wichita County,TX,9,4,10,1,1,5,30
TX - Wise County,Wise County,TX,9,4,10,1,1,5,30
TX - Andrews County,Andrews County,TX,9,2,8,1,3,5,28
TX - Archer County,Archer County,TX,9,4,10,1,1,4,29
TX - Bell County,Bell County,TX,9,4,8,1,2,5,29
TX - Burleson County,Burleson County,TX,9,4,9,1,1,5,29
TX - Clay County,Clay County,TX,9,4,10,1,1,4,29
TX - Collin County,Collin County,TX,9,4,9,1,1,5,29
TX - Comal County,Comal County,TX,7,2,10,1,2,5,27
TX - Cottle County,Cottle County,TX,9,4,8,1,2,5,29
TX - Dawson County,Dawson County,TX,9,2,8,1,3,5,28
TX - El Paso County,El Paso County,TX,9,2,8,1,3,5,28
TX - Fisher County,Fisher County,TX,9,4,8,1,2,5,29
TX - Gaines County,Gaines County,TX,9,2,8,1,3,5,28
TX - Gillespie County,Gillespie County,TX,7,2,10,1,2,5,27
TX - Guadalupe County,Guadalupe County,TX,9,4,8,1,2,5,29
TX - Harrison County,Harrison County,TX,7,4,10,1,1,5,28
TX - Hays County,Hays County,TX,7,2,10,1,2,5,27
TX - Houston County,Houston County,TX,7,2,10,1,1,6,27
TX - Hunt County,Hunt County,TX,9,4,9,1,1,5,29
TX - Jackson County,Jackson County,TX,7,2,7,4,1,7,28
TX - Kerr County,Kerr County,TX,7,2,10,1,2,5,27
TX - Lamar County,Lamar County,TX,9,4,9,1,1,5,29
TX - Madison County,Madison County,TX,9,2,10,1,1,5,28
TX - Matagorda County,Matagorda County,TX,3,2,8,4,1,8,26
TX - Montague County,Montague County,TX,9,4,10,1,1,4,29
TX - Panola County,Panola County,TX,7,4,10,1,1,5,28
TX - Robertson County,Robertson County,TX,9,4,9,1,1,5,29
TX - Sutton County,Sutton County,TX,9,2,8,1,3,5,28
TX - Terry County,Terry County,TX,9,2,8,1,3,5,28
TX - Travis County,Travis County,TX,9,4,9,1,1,5,29
TX - Uvalde County,Uvalde County,TX,9,4,9,1,1,5,29
TX - Washington County,Washington County,TX,9,4,9,1,1,5,29
TX - Anderson County,Anderson County,TX,7,2,10,1,1,5,26
TX - Bandera County,Bandera County,TX,7,2,8,1,2,6,26
TX - Bowie County,Bowie County,TX,7,4,9,1,1,5,27
TX - Cass County,Cass County,TX,7,4,9,1,1,5,27
TX - Cherokee County,Cherokee County,TX,7,2,10,1,1,5,26
TX - Cooke County,Cooke County,TX,7,2,10,1,1,5,26
TX - Donley County,Donley County,TX,9,2,8,1,3,4,27
TX - Falls County,Falls County,TX,9,4,8,1,1,5,28
TX - Fannin County,Fannin County,TX,9,4,9,1,1,4,28
TX - Franklin County,Franklin County,TX,7,2,10,1,1,5,26
TX - Frio County,Frio County,TX,10,2,8,1,1,5,27
TX - Grayson County,Grayson County,TX,7,4,9,1,1,5,27
TX - Leon County,Leon County,TX,9,2,9,1,1,5,27
TX - Lubbock County,Lubbock County,TX,9,2,8,1,2,5,27
TX - Lynn County,Lynn County,TX,9,2,8,1,2,5,27
TX - McLennan County,McLennan County,TX,9,4,8,1,1,5,28
TX - Milam County,Milam County,TX,9,4,8,1,1,5,28
TX - Nacogdoches County,Nacogdoches County,TX,9,2,9,1,1,5,27
TX - Nolan County,Nolan County,TX,9,2,8,1,2,5,27
TX - Orange County,Orange County,TX,6,10,1,4,1,8,30
TX - Rusk County,Rusk County,TX,7,2,10,1,1,5,26
TX - San Augustine County,San Augustine County,TX,7,2,10,1,1,5,26
TX - Smith County,Smith County,TX,7,2,10,1,1,5,26
TX - Upshur County,Upshur County,TX,7,2,10,1,1,5,26
TX - Victoria County,Victoria County,TX,9,2,8,3,1,5,28
TX - Wharton County,Wharton County,TX,7,2,8,1,1,6,25
TX - Wheeler County,Wheeler County,TX,7,2,8,1,3,5,26
TX - Williamson County,Williamson County,TX,9,4,8,1,1,5,28
TX - Armstrong County,Armstrong County,TX,7,2,8,1,3,4,25
TX - Crosby County,Crosby County,TX,7,2,8,1,2,5,25
TX - Delta County,Delta County,TX,7,2,9,1,1,5,25
TX - Ellis County,Ellis County,TX,7,4,8,1,1,5,26
TX - Floyd County,Floyd County,TX,7,2,8,1,3,4,25
TX - Gray County,Gray County,TX,7,2,8,1,3,4,25
TX - Hill County,Hill County,TX,9,4,8,1,1,5,28
TX - Hudspeth County,Hudspeth County,TX,9,2,3,1,6,5,26
TX - Hutchinson County,Hutchinson County,TX,9,2,8,1,2,4,26
TX - Red River County,Red River County,TX,7,2,9,1,1,5,25
TX - Briscoe County,Briscoe County,TX,7,2,8,1,2,4,24
TX - Hale County,Hale County,TX,7,2,8,1,3,4,25
TX - Hockley County,Hockley County,TX,7,2,8,1,3,4,25
TX - Lipscomb County,Lipscomb County,TX,7,2,8,1,2,4,24
TX - Potter County,Potter County,TX,7,2,8,1,2,5,25
TX - Roberts County,Roberts County,TX,7,2,8,1,2,4,24
TX - Terrell County,Terrell County,TX,10,5,1,1,6,5,28
TX - Cochran County,Cochran County,TX,7,2,8,1,2,4,24
TX - Duval County,Duval County,TX,10,5,1,1,1,8,26
TX - Hansford County,Hansford County,TX,7,2,8,1,2,4,24
TX - Lamb County,Lamb County,TX,7,2,8,1,2,4,24
TX - Ochiltree County,Ochiltree County,TX,7,2,8,1,2,4,24
TX - Oldham County,Oldham County,TX,7,2,7,1,3,4,24
TX - Presidio County,Presidio County,TX,10,6,1,1,4,5,27
TX - Val Verde County,Val Verde County,TX,10,5,1,1,5,5,27
TX - Brooks County,Brooks County,TX,10,5,1,1,1,7,25
TX - Carson County,Carson County,TX,7,1,8,1,2,4,23
TX - Culberson County,Culberson County,TX,7,2,1,1,7,5,23
TX - Deaf Smith County,Deaf Smith County,TX,7,2,6,1,3,4,23
TX - Moore County,Moore County,TX,7,2,7,1,2,4,23
TX - Randall County,Randall County,TX,7,2,7,1,2,4,23
TX - Swisher County,Swisher County,TX,7,1,8,1,2,4,23
TX - Bailey County,Bailey County,TX,7,1,7,1,2,4,22
TX - Crockett County,Crockett County,TX,9,4,1,1,5,5,25
TX - Edwards County,Edwards County,TX,10,5,1,1,3,5,25
TX - Hartley County,Hartley County,TX,7,1,6,1,3,4,22
TX - Jim Hogg County,Jim Hogg County,TX,10,5,1,1,1,6,24
TX - Polk County,Polk County,TX,9,4,1,1,1,8,24
TX - Reeves County,Reeves County,TX,9,2,1,1,6,5,24
TX - Sherman County,Sherman County,TX,7,1,7,1,2,4,22
TX - Trinity County,Trinity County,TX,9,4,1,1,1,8,24
TX - Castro County,Castro County,TX,7,1,7,1,1,4,21
TX - Dallam County,Dallam County,TX,7,1,6,1,2,4,21
TX - Loving County,Loving County,TX,10,4,1,1,3,5,24
TX - Martin County,Martin County,TX,10,4,1,1,3,5,24
TX - Midland County,Midland County,TX,10,4,1,1,3,5,24
TX - Ward County,Ward County,TX,10,4,1,1,3,5,24
TX - Winkler County,Winkler County,TX,10,4,1,1,3,5,24
TX - Zapata County,Zapata County,TX,10,6,1,1,1,5,24
TX - Glasscock County,Glasscock County,TX,9,4,1,1,3,5,23
TX - Hardin County,Hardin County,TX,6,2,1,3,1,8,21
TX - Howard County,Howard County,TX,9,4,1,1,3,5,23
TX - Kenedy County,Kenedy County,TX,10,5,1,1,1,5,23
TX - Maverick County,Maverick County,TX,10,5,1,1,1,5,23
TX - Newton County,Newton County,TX,7,2,1,1,1,8,20
TX - San Saba County,San Saba County,TX,10,4,1,1,2,5,23
TX - Schleicher County,Schleicher County,TX,9,4,1,1,3,5,23
TX - Upton County,Upton County,TX,9,4,1,1,3,5,23
TX - Yoakum County,Yoakum County,TX,9,2,2,1,3,5,22
TX - Blanco County,Blanco County,TX,9,4,1,1,2,5,22
TX - Childress County,Childress County,TX,9,4,1,1,2,5,22
TX - Crane County,Crane County,TX,9,2,1,1,3,5,21
TX - Eastland County,Eastland County,TX,9,4,1,1,2,5,22
TX - Ector County,Ector County,TX,9,2,1,1,3,5,21
TX - Foard County,Foard County,TX,9,4,1,1,2,5,22
TX - Hall County,Hall County,TX,9,4,1,1,2,5,22
TX - King County,King County,TX,9,4,1,1,2,5,22
TX - Knox County,Knox County,TX,9,4,1,1,2,5,22
TX - McMullen County,McMullen County,TX,10,4,1,1,1,5,22
TX - Parmer County,Parmer County,TX,6,1,6,1,1,4,19
TX - Sabine County,Sabine County,TX,7,2,1,1,1,7,19
TX - Scurry County,Scurry County,TX,9,4,1,1,2,5,22
TX - Sterling County,Sterling County,TX,9,2,1,1,3,5,21
TX - Stonewall County,Stonewall County,TX,9,4,1,1,2,5,22
TX - Kimble County,Kimble County,TX,9,2,1,1,2,5,20
TX - Baylor County,Baylor County,TX,9,4,1,1,1,5,21
TX - Brown County,Brown County,TX,9,4,1,1,1,5,21
TX - Coke County,Coke County,TX,9,2,1,1,2,5,20
TX - Dickens County,Dickens County,TX,9,2,1,1,2,5,20
TX - Hardeman County,Hardeman County,TX,9,2,1,1,2,5,20
TX - Irion County,Irion County,TX,9,2,1,1,2,5,20
TX - Jeff Davis County,Jeff Davis County,TX,4,1,1,1,6,5,18
TX - Kendall County,Kendall County,TX,9,2,1,1,2,5,20
TX - Kent County,Kent County,TX,9,2,1,1,2,5,20
TX - Lampasas County,Lampasas County,TX,9,4,1,1,1,5,21
TX - Mason County,Mason County,TX,9,2,1,1,2,5,20
TX - Menard County,Menard County,TX,9,2,1,1,2,5,20
TX - Mills County,Mills County,TX,9,4,1,1,1,5,21
TX - Mitchell County,Mitchell County,TX,9,2,1,1,2,5,20
TX - Motley County,Motley County,TX,9,2,1,1,2,5,20
TX - Palo Pinto County,Palo Pinto County,TX,9,4,1,1,1,5,21
TX - Parker County,Parker County,TX,9,4,1,1,1,5,21
TX - Rains County,Rains County,TX,9,4,1,1,1,5,21
TX - Real County,Real County,TX,7,2,1,1,2,6,19
TX - Shackelford County,Shackelford County,TX,9,4,1,1,1,5,21
TX - Stephens County,Stephens County,TX,9,4,1,1,1,5,21
TX - Young County,Young County,TX,9,4,1,1,1,5,21
TX - Angelina County,Angelina County,TX,9,2,1,1,1,5,19
TX - Burnet County,Burnet County,TX,9,2,1,1,1,5,19
TX - Garza County,Garza County,TX,7,2,1,1,2,5,18
TX - Gregg County,Gregg County,TX,7,4,1,1,1,5,19
TX - Hemphill County,Hemphill County,TX,7,2,1,1,2,5,18
TX - Henderson County,Henderson County,TX,7,4,1,1,1,5,19
TX - Jack County,Jack County,TX,9,4,1,1,1,4,20
TX - Marion County,Marion County,TX,7,4,1,1,1,5,19
TX - Somervell County,Somervell County,TX,9,2,1,1,1,5,19
TX - Camp County,Camp County,TX,7,2,1,1,1,5,17
TX - Hopkins County,Hopkins County,TX,7,2,1,1,1,5,17
TX - Morris County,Morris County,TX,7,2,1,1,1,5,17
TX - Titus County,Titus County,TX,7,2,1,1,1,5,17
TX - Wood County,Wood County,TX,7,2,1,1,1,5,17
UT - Washington County,Washington County,UT,7,2,5,1,9,5,29
UT - Tooele County,Tooele County,UT,7,2,5,1,9,4,28
UT - Juab County,Juab County,UT,7,2,4,1,8,4,26
UT - Millard County,Millard County,UT,7,1,4,1,9,4,26
UT - Salt Lake County,Salt Lake County,UT,7,2,5,1,7,4,26
UT - Davis County,Davis County,UT,7,2,4,1,7,4,25
UT - Box Elder County,Box Elder County,UT,4,1,4,1,9,4,23
UT - Utah County,Utah County,UT,6,1,4,1,8,4,24
UT - San Juan County,San Juan County,UT,4,1,4,1,8,4,22
UT - Beaver County,Beaver County,UT,7,1,3,1,6,4,22
UT - Emery County,Emery County,UT,6,1,4,1,6,4,22
UT - Uintah County,Uintah County,UT,7,1,4,1,6,4,23
UT - Cache County,Cache County,UT,4,1,4,1,6,4,20
UT - Sevier County,Sevier County,UT,6,1,3,1,6,4,21
UT - Weber County,Weber County,UT,4,1,4,1,6,4,20
UT - Carbon County,Carbon County,UT,4,1,3,1,6,4,19
UT - Duchesne County,Duchesne County,UT,4,1,3,1,6,4,19
UT - Grand County,Grand County,UT,6,2,1,1,6,4,20
UT - Iron County,Iron County,UT,4,1,1,1,8,4,19
UT - Morgan County,Morgan County,UT,6,1,1,1,6,4,19
UT - Sanpete County,Sanpete County,UT,4,1,1,1,7,4,18
UT - Wayne County,Wayne County,UT,6,1,1,1,6,4,19
UT - Garfield County,Garfield County,UT,3,1,1,1,7,4,17
UT - Summit County,Summit County,UT,4,1,1,1,6,4,17
UT - Wasatch County,Wasatch County,UT,6,1,1,1,6,4,19
UT - Kane County,Kane County,UT,3,1,1,1,6,4,16
UT - Piute County,Piute County,UT,4,1,1,1,6,4,17
UT - Rich County,Rich County,UT,3,1,1,1,6,4,16
UT - Daggett County,Daggett County,UT,4,1,1,1,3,4,14
VA - Charles City County,Charles City County,VA,6,6,7,4,1,5,29
VA - Suffolk city,Suffolk city,VA,6,4,8,4,2,5,29
VA - Isle of Wight County,Isle of Wight County,VA,6,4,7,4,2,5,28
VA - Chesapeake city,Chesapeake city,VA,4,5,7,4,2,5,27
VA - Virginia Beach city,Virginia Beach city,VA,4,5,7,4,2,5,27
VA - Henrico County,Henrico County,VA,6,5,8,3,1,4,27
VA - Northampton County,Northampton County,VA,4,7,3,4,1,6,25
VA - Southampton County,Southampton County,VA,4,4,8,4,1,5,26
VA - King and Queen County,King and Queen County,VA,6,5,5,4,1,5,26
VA - King William County,King William County,VA,6,4,6,4,1,5,26
VA - New Kent County,New Kent County,VA,6,5,6,4,1,4,26
VA - Prince George County,Prince George County,VA,6,5,7,3,1,4,26
VA - Poquoson city,Poquoson city,VA,4,5,1,6,1,9,26
VA - Lancaster County,Lancaster County,VA,6,6,3,4,1,5,25
VA - Middlesex County,Middlesex County,VA,6,6,3,4,1,5,25
VA - Accomack County,Accomack County,VA,3,5,3,7,1,5,24
VA - Essex County,Essex County,VA,4,5,4,4,1,5,23
VA - Northumberland County,Northumberland County,VA,4,6,3,4,1,5,23
VA - Chesterfield County,Chesterfield County,VA,6,2,6,3,1,4,22
VA - Gloucester County,Gloucester County,VA,4,5,3,4,1,5,22
VA - Goochland County,Goochland County,VA,4,2,8,1,1,4,20
VA - Hanover County,Hanover County,VA,4,2,7,3,1,4,21
VA - James City County,James City County,VA,4,4,5,4,1,4,22
VA - Surry County,Surry County,VA,4,4,4,4,1,5,22
VA - Sussex County,Sussex County,VA,4,4,7,1,1,4,21
VA - Newport News city,Newport News city,VA,4,5,1,7,2,5,24
VA - Greensville County,Greensville County,VA,4,1,7,1,1,5,19
VA - King George County,King George County,VA,4,4,4,4,1,4,21
VA - Powhatan County,Powhatan County,VA,4,2,7,1,1,4,19
VA - Prince William County,Prince William County,VA,4,4,5,3,1,4,21
VA - Richmond County,Richmond County,VA,4,5,3,4,1,4,21
VA - Stafford County,Stafford County,VA,4,2,5,4,1,4,20
VA - Caroline County,Caroline County,VA,4,2,4,3,1,5,19
VA - Dinwiddie County,Dinwiddie County,VA,4,2,6,1,1,4,18
VA - Fairfax County,Fairfax County,VA,4,4,4,3,1,4,20
VA - Loudoun County,Loudoun County,VA,4,2,5,1,2,4,18
VA - Hampton city,Hampton city,VA,4,5,1,4,2,5,21
VA - Norfolk city,Norfolk city,VA,4,5,1,4,2,5,21
VA - Portsmouth city,Portsmouth city,VA,4,5,1,4,2,5,21
VA - Mathews County,Mathews County,VA,4,5,1,6,1,5,22
VA - Amelia County,Amelia County,VA,4,1,6,1,1,4,17
VA - Buckingham County,Buckingham County,VA,4,1,6,1,1,4,17
VA - Fluvanna County,Fluvanna County,VA,4,2,5,1,1,4,17
VA - Henry County,Henry County,VA,4,1,6,1,1,4,17
VA - Lunenburg County,Lunenburg County,VA,6,2,4,1,1,4,18
VA - Mecklenburg County,Mecklenburg County,VA,6,2,4,1,1,4,18
VA - Orange County,Orange County,VA,4,2,5,1,1,4,17
VA - Westmoreland County,Westmoreland County,VA,4,2,3,4,1,4,18
VA - York County,York County,VA,4,5,1,4,1,5,20
VA - Colonial Heights city,Colonial Heights city,VA,6,5,1,4,1,4,21
VA - Albemarle County,Albemarle County,VA,4,2,4,1,1,4,16
VA - Brunswick County,Brunswick County,VA,4,1,5,1,1,4,16
VA - Clarke County,Clarke County,VA,3,2,4,1,2,4,16
VA - Craig County,Craig County,VA,4,2,3,1,2,4,16
VA - Culpeper County,Culpeper County,VA,4,2,4,1,1,4,16
VA - Louisa County,Louisa County,VA,4,2,4,1,1,4,16
VA - Madison County,Madison County,VA,4,1,4,1,2,4,16
VA - Rappahannock County,Rappahannock County,VA,4,1,4,1,2,4,16
VA - Hopewell city,Hopewell city,VA,6,5,1,3,1,4,20
VA - Williamsburg city,Williamsburg city,VA,4,5,1,3,1,5,19
VA - Amherst County,Amherst County,VA,4,1,4,1,1,4,15
VA - Bedford County,Bedford County,VA,4,1,3,1,2,4,15
VA - Botetourt County,Botetourt County,VA,4,1,3,1,2,4,15
VA - Carroll County,Carroll County,VA,4,1,3,1,2,4,15
VA - Charlotte County,Charlotte County,VA,6,1,3,1,1,4,16
VA - Cumberland County,Cumberland County,VA,4,1,4,1,1,4,15
VA - Fauquier County,Fauquier County,VA,3,2,4,1,1,4,15
VA - Frederick County,Frederick County,VA,4,1,3,1,2,4,15
VA - Greene County,Greene County,VA,4,2,3,1,1,4,15
VA - Halifax County,Halifax County,VA,4,1,4,1,1,4,15
VA - Lee County,Lee County,VA,4,1,3,1,2,4,15
VA - Nelson County,Nelson County,VA,4,1,3,1,2,4,15
VA - Nottoway County,Nottoway County,VA,4,1,4,1,1,4,15
VA - Page County,Page County,VA,4,1,3,1,2,4,15
VA - Prince Edward County,Prince Edward County,VA,4,1,4,1,1,4,15
VA - Rockbridge County,Rockbridge County,VA,4,1,3,1,2,4,15
VA - Scott County,Scott County,VA,4,1,3,1,2,4,15
VA - Shenandoah County,Shenandoah County,VA,4,1,3,1,2,4,15
VA - Spotsylvania County,Spotsylvania County,VA,4,2,3,1,1,4,15
VA - Warren County,Warren County,VA,4,1,3,1,2,4,15
VA - Petersburg city,Petersburg city,VA,6,5,1,1,1,4,18
VA - Appomattox County,Appomattox County,VA,4,1,3,1,1,4,14
VA - Augusta County,Augusta County,VA,3,1,3,1,2,4,14
VA - Bath County,Bath County,VA,3,1,3,1,2,4,14
VA - Bland County,Bland County,VA,3,1,3,1,2,4,14
VA - Buchanan County,Buchanan County,VA,3,1,3,1,2,4,14
VA - Campbell County,Campbell County,VA,4,1,3,1,1,4,14
VA - Dickenson County,Dickenson County,VA,3,1,3,1,2,4,14
VA - Franklin County,Franklin County,VA,4,1,3,1,1,4,14
VA - Giles County,Giles County,VA,3,1,3,1,2,4,14
VA - Grayson County,Grayson County,VA,3,1,3,1,2,4,14
VA - Montgomery County,Montgomery County,VA,3,1,3,1,2,4,14
VA - Patrick County,Patrick County,VA,4,1,3,1,1,4,14
VA - Pittsylvania County,Pittsylvania County,VA,4,1,3,1,1,4,14
VA - Pulaski County,Pulaski County,VA,3,1,3,1,2,4,14
VA - Rockingham County,Rockingham County,VA,3,1,3,1,2,4,14
VA - Russell County,Russell County,VA,3,1,3,1,2,4,14
VA - Smyth County,Smyth County,VA,3,1,3,1,2,4,14
VA - Tazewell County,Tazewell County,VA,3,1,3,1,2,4,14
VA - Washington County,Washington County,VA,3,1,3,1,2,4,14
VA - Wise County,Wise County,VA,3,1,3,1,2,4,14
VA - Wythe County,Wythe County,VA,3,1,3,1,2,4,14
VA - Franklin city,Franklin city,VA,6,4,1,1,1,4,17
VA - Richmond city,Richmond city,VA,6,2,1,3,1,4,17
VA - Alexandria city,Alexandria city,VA,4,2,1,3,1,5,16
VA - Falls Church city,Falls Church city,VA,4,4,1,1,1,5,16
VA - Manassas city,Manassas city,VA,4,4,1,1,1,5,16
VA - Floyd County,Floyd County,VA,3,1,3,1,1,4,13
VA - Highland County,Highland County,VA,1,1,3,1,2,4,12
VA - Fairfax city,Fairfax city,VA,4,4,1,1,1,4,15
VA - Manassas Park city,Manassas Park city,VA,4,4,1,1,1,4,15
VA - Galax city,Galax city,VA,4,2,1,1,1,5,14
VA - Alleghany County,Alleghany County,VA,4,1,1,1,2,4,13
VA - Arlington County,Arlington County,VA,4,2,1,1,1,4,13
VA - Roanoke County,Roanoke County,VA,4,1,1,1,2,4,13
VA - Charlottesville city,Charlottesville city,VA,4,2,1,1,1,4,13
VA - Emporia city,Emporia city,VA,4,1,1,1,1,5,13
VA - Fredericksburg city,Fredericksburg city,VA,4,2,1,1,1,4,13
VA - Buena Vista city,Buena Vista city,VA,4,1,1,1,1,5,13
VA - Covington city,Covington city,VA,4,1,1,1,1,5,13
VA - Lexington city,Lexington city,VA,4,1,1,1,1,5,13
VA - Winchester city,Winchester city,VA,4,1,1,1,1,5,13
VA - Danville city,Danville city,VA,4,1,1,1,1,4,12
VA - Lynchburg city,Lynchburg city,VA,4,1,1,1,1,4,12
VA - Martinsville city,Martinsville city,VA,4,1,1,1,1,4,12
VA - Roanoke city,Roanoke city,VA,4,1,1,1,1,4,12
VA - Salem city,Salem city,VA,4,1,1,1,1,4,12
VA - Radford city,Radford city,VA,3,1,1,1,1,5,12
VA - Staunton city,Staunton city,VA,3,1,1,1,1,5,12
VA - Waynesboro city,Waynesboro city,VA,3,1,1,1,1,5,12
VA - Bristol city,Bristol city,VA,3,1,1,1,1,4,11
VA - Harrisonburg city,Harrisonburg city,VA,3,1,1,1,1,4,11
VA - Norton city,Norton city,VA,3,1,1,1,1,4,11
VT - Chittenden County,Chittenden County,VT,3,4,1,1,1,4,14
VT - Rutland County,Rutland County,VT,3,4,1,1,1,3,13
VT - Washington County,Washington County,VT,3,4,1,1,1,3,13
VT - Windham County,Windham County,VT,3,4,1,1,1,3,13
VT - Windsor County,Windsor County,VT,3,4,1,1,1,3,13
VT - Addison County,Addison County,VT,3,2,1,1,1,3,11
VT - Bennington County,Bennington County,VT,3,2,1,1,1,3,11
VT - Caledonia County,Caledonia County,VT,3,4,1,1,1,2,12
VT - Grand Isle County,Grand Isle County,VT,3,4,1,1,1,1,11
VT - Orleans County,Orleans County,VT,3,2,1,1,1,2,10
VT - Essex County,Essex County,VT,3,2,1,1,1,1,9
VT - Franklin County,Franklin County,VT,1,1,1,1,1,3,8
VT - Orange County,Orange County,VT,3,2,1,1,1,1,9
VT - Lamoille County,Lamoille County,VT,1,1,1,1,1,2,7
WA - Grant County,Grant County,WA,4,1,5,1,9,5,25
WA - Benton County,Benton County,WA,4,1,5,1,8,5,24
WA - Yakima County,Yakima County,WA,4,1,4,1,9,5,24
WA - Douglas County,Douglas County,WA,6,1,4,1,8,4,24
WA - Lincoln County,Lincoln County,WA,4,1,4,1,8,4,22
WA - Okanogan County,Okanogan County,WA,4,1,4,1,8,4,22
WA - Chelan County,Chelan County,WA,4,1,4,1,7,4,21
WA - Ferry County,Ferry County,WA,4,1,4,1,7,4,21
WA - Kittitas County,Kittitas County,WA,4,1,3,1,7,4,20
WA - Klickitat County,Klickitat County,WA,4,1,1,1,8,4,19
WA - Walla Walla County,Walla Walla County,WA,6,1,6,1,1,5,20
WA - Asotin County,Asotin County,WA,6,1,1,1,6,4,19
WA - Franklin County,Franklin County,WA,6,1,5,1,1,5,19
WA - Snohomish County,Snohomish County,WA,3,2,3,4,3,4,19
WA - Stevens County,Stevens County,WA,4,1,1,1,7,4,18
WA - Clark County,Clark County,WA,3,2,3,3,3,4,18
WA - Columbia County,Columbia County,WA,6,1,5,1,1,4,18
WA - Pacific County,Pacific County,WA,3,4,3,4,1,4,19
WA - Pierce County,Pierce County,WA,3,2,3,3,3,4,18
WA - Adams County,Adams County,WA,4,1,4,1,1,5,16
WA - Cowlitz County,Cowlitz County,WA,3,2,1,4,4,4,18
WA - Garfield County,Garfield County,WA,4,1,1,1,6,4,17
WA - Island County,Island County,WA,3,2,3,4,1,4,17
WA - Lewis County,Lewis County,WA,4,2,1,1,5,4,17
WA - Pend Oreille County,Pend Oreille County,WA,4,1,1,1,6,4,17
WA - Skamania County,Skamania County,WA,4,1,1,1,6,4,17
WA - Skagit County,Skagit County,WA,3,2,1,4,3,4,17
WA - Spokane County,Spokane County,WA,4,1,4,1,1,4,15
WA - Whitman County,Whitman County,WA,4,1,4,1,1,4,15
WA - King County,King County,WA,3,2,1,3,3,4,16
WA - Whatcom County,Whatcom County,WA,3,1,3,3,1,4,15
WA - Kitsap County,Kitsap County,WA,3,2,1,4,1,4,15
WA - Thurston County,Thurston County,WA,3,2,1,4,1,4,15
WA - Clallam County,Clallam County,WA,3,1,1,4,1,4,14
WA - Grays Harbor County,Grays Harbor County,WA,3,1,1,4,1,4,14
WA - Jefferson County,Jefferson County,WA,3,1,1,4,1,4,14
WA - Mason County,Mason County,WA,3,1,1,4,1,4,14
WA - Wahkiakum County,Wahkiakum County,WA,3,1,1,4,1,4,14
WA - San Juan County,San Juan County,WA,3,1,1,3,1,4,13
WI - Douglas County,Douglas County,WI,3,5,3,1,3,4,19
WI - Bayfield County,Bayfield County,WI,3,4,3,1,3,4,18
WI - Oneida County,Oneida County,WI,3,4,3,1,3,4,18
WI - Price County,Price County,WI,3,4,3,1,3,4,18
WI - Rock County,Rock County,WI,4,5,3,1,1,4,18
WI - Rusk County,Rusk County,WI,3,4,3,1,3,4,18
WI - Sawyer County,Sawyer County,WI,3,4,3,1,3,4,18
WI - Walworth County,Walworth County,WI,3,5,4,1,1,4,18
WI - Washburn County,Washburn County,WI,3,5,3,1,2,4,18
WI - Adams County,Adams County,WI,4,4,3,1,1,4,17
WI - Crawford County,Crawford County,WI,3,5,3,1,1,4,17
WI - Eau Claire County,Eau Claire County,WI,4,4,3,1,1,4,17
WI - Forest County,Forest County,WI,3,2,3,1,3,4,16
WI - Green County,Green County,WI,3,4,3,1,1,5,17
WI - Jefferson County,Jefferson County,WI,3,5,3,1,1,4,17
WI - Juneau County,Juneau County,WI,4,4,3,1,1,4,17
WI - La Crosse County,La Crosse County,WI,4,4,3,1,1,4,17
WI - Lafayette County,Lafayette County,WI,3,4,3,1,1,5,17
WI - Milwaukee County,Milwaukee County,WI,3,5,3,1,1,4,17
WI - Racine County,Racine County,WI,3,5,3,1,1,4,17
WI - Vernon County,Vernon County,WI,3,4,3,1,1,5,17
WI - Waukesha County,Waukesha County,WI,3,5,3,1,1,4,17
WI - Ashland County,Ashland County,WI,3,4,3,1,1,4,16
WI - Barron County,Barron County,WI,3,4,3,1,1,4,16
WI - Buffalo County,Buffalo County,WI,3,4,3,1,1,4,16
WI - Chippewa County,Chippewa County,WI,3,4,3,1,1,4,16
WI - Clark County,Clark County,WI,3,4,3,1,1,4,16
WI - Columbia County,Columbia County,WI,3,4,3,1,1,4,16
WI - Dane County,Dane County,WI,3,4,3,1,1,4,16
WI - Dodge County,Dodge County,WI,3,4,3,1,1,4,16
WI - Dunn County,Dunn County,WI,3,4,3,1,1,4,16
WI - Florence County,Florence County,WI,3,2,3,1,2,4,15
WI - Fond du Lac County,Fond du Lac County,WI,3,4,3,1,1,4,16
WI - Grant County,Grant County,WI,3,4,3,1,1,4,16
WI - Green Lake County,Green Lake County,WI,3,4,3,1,1,4,16
WI - Iowa County,Iowa County,WI,3,4,3,1,1,4,16
WI - Jackson County,Jackson County,WI,3,4,3,1,1,4,16
WI - Kenosha County,Kenosha County,WI,3,4,3,1,1,4,16
WI - Lincoln County,Lincoln County,WI,3,2,3,1,2,4,15
WI - Marinette County,Marinette County,WI,3,1,3,1,3,4,15
WI - Marquette County,Marquette County,WI,3,4,3,1,1,4,16
WI - Oconto County,Oconto County,WI,3,4,3,1,1,4,16
WI - Pepin County,Pepin County,WI,3,4,3,1,1,4,16
WI - Richland County,Richland County,WI,3,4,3,1,1,4,16
WI - St. Croix County,St. Croix County,WI,3,2,3,1,2,4,15
WI - Sauk County,Sauk County,WI,3,4,3,1,1,4,16
WI - Sheboygan County,Sheboygan County,WI,3,4,3,1,1,4,16
WI - Taylor County,Taylor County,WI,3,4,3,1,1,4,16
WI - Trempealeau County,Trempealeau County,WI,3,4,3,1,1,4,16
WI - Washington County,Washington County,WI,3,4,3,1,1,4,16
WI - Burnett County,Burnett County,WI,3,2,3,1,1,4,14
WI - Door County,Door County,WI,3,2,3,1,1,4,14
WI - Kewaunee County,Kewaunee County,WI,3,2,3,1,1,4,14
WI - Langlade County,Langlade County,WI,3,2,3,1,1,4,14
WI - Monroe County,Monroe County,WI,3,2,3,1,1,4,14
WI - Ozaukee County,Ozaukee County,WI,3,2,3,1,1,4,14
WI - Pierce County,Pierce County,WI,3,2,3,1,1,4,14
WI - Waupaca County,Waupaca County,WI,3,2,3,1,1,4,14
WI - Waushara County,Waushara County,WI,3,2,3,1,1,4,14
WI - Wood County,Wood County,WI,3,2,3,1,1,4,14
WI - Brown County,Brown County,WI,3,1,3,1,1,4,13
WI - Calumet County,Calumet County,WI,3,1,3,1,1,4,13
WI - Iron County,Iron County,WI,3,4,1,1,2,4,15
WI - Manitowoc County,Manitowoc County,WI,3,1,3,1,1,4,13
WI - Marathon County,Marathon County,WI,3,1,3,1,1,4,13
WI - Outagamie County,Outagamie County,WI,3,1,3,1,1,4,13
WI - Polk County,Polk County,WI,3,1,3,1,1,4,13
WI - Portage County,Portage County,WI,3,1,3,1,1,4,13
WI - Shawano County,Shawano County,WI,3,1,3,1,1,4,13
WI - Winnebago County,Winnebago County,WI,3,1,3,1,1,4,13
WI - Vilas County,Vilas County,WI,3,2,1,1,2,4,13
WI - Menominee County,Menominee County,WI,3,1,1,1,1,4,11
WV - Mason County,Mason County,WV,6,7,3,1,2,4,23
WV - Wood County,Wood County,WV,4,5,4,1,2,5,21
WV - Gilmer County,Gilmer County,WV,4,5,4,1,2,4,20
WV - Lincoln County,Lincoln County,WV,4,5,4,1,2,4,20
WV - Putnam County,Putnam County,WV,4,5,4,1,2,4,20
WV - Wayne County,Wayne County,WV,4,5,4,1,2,4,20
WV - Cabell County,Cabell County,WV,4,4,4,1,2,4,19
WV - Jackson County,Jackson County,WV,4,5,3,1,2,4,19
WV - Kanawha County,Kanawha County,WV,4,4,4,1,2,4,19
WV - Pleasants County,Pleasants County,WV,4,4,4,1,2,4,19
WV - Ritchie County,Ritchie County,WV,4,4,4,1,2,4,19
WV - Berkeley County,Berkeley County,WV,4,2,4,1,2,4,17
WV - Braxton County,Braxton County,WV,3,4,4,1,2,4,18
WV - Brooke County,Brooke County,WV,3,4,3,1,2,5,18
WV - Hancock County,Hancock County,WV,3,4,3,1,2,5,18
WV - Jefferson County,Jefferson County,WV,4,2,4,1,2,4,17
WV - Marion County,Marion County,WV,4,4,3,1,2,4,18
WV - Morgan County,Morgan County,WV,4,2,4,1,2,4,17
WV - Tyler County,Tyler County,WV,3,4,4,1,2,4,18
WV - Wirt County,Wirt County,WV,3,4,4,1,2,4,18
WV - Boone County,Boone County,WV,4,2,3,1,2,4,16
WV - Calhoun County,Calhoun County,WV,3,4,3,1,2,4,17
WV - Doddridge County,Doddridge County,WV,3,4,3,1,2,4,17
WV - Harrison County,Harrison County,WV,3,4,3,1,2,4,17
WV - Marshall County,Marshall County,WV,3,4,3,1,2,4,17
WV - Mineral County,Mineral County,WV,4,2,3,1,2,4,16
WV - Monongalia County,Monongalia County,WV,3,4,3,1,2,4,17
WV - Nicholas County,Nicholas County,WV,3,4,3,1,2,4,17
WV - Ohio County,Ohio County,WV,3,4,3,1,2,4,17
WV - Roane County,Roane County,WV,3,4,3,1,2,4,17
WV - Barbour County,Barbour County,WV,3,2,3,1,2,4,15
WV - Fayette County,Fayette County,WV,3,2,3,1,2,4,15
WV - Grant County,Grant County,WV,4,1,3,1,2,4,15
WV - Hardy County,Hardy County,WV,4,1,3,1,2,4,15
WV - Logan County,Logan County,WV,4,5,1,1,2,4,17
WV - Preston County,Preston County,WV,3,2,3,1,2,4,15
WV - Randolph County,Randolph County,WV,3,2,3,1,2,4,15
WV - Tucker County,Tucker County,WV,3,2,3,1,2,4,15
WV - Upshur County,Upshur County,WV,3,2,3,1,2,4,15
WV - Wetzel County,Wetzel County,WV,3,2,3,1,2,4,15
WV - Greenbrier County,Greenbrier County,WV,3,1,3,1,2,4,14
WV - Hampshire County,Hampshire County,WV,4,1,3,1,2,3,14
WV - Mercer County,Mercer County,WV,3,1,3,1,2,4,14
WV - Mingo County,Mingo County,WV,4,4,1,1,2,4,16
WV - Monroe County,Monroe County,WV,3,1,3,1,2,4,14
WV - Raleigh County,Raleigh County,WV,3,1,3,1,2,4,14
WV - Summers County,Summers County,WV,3,1,3,1,2,4,14
WV - Taylor County,Taylor County,WV,4,4,1,1,2,4,16
WV - Clay County,Clay County,WV,3,4,1,1,2,4,15
WV - Pendleton County,Pendleton County,WV,3,1,3,1,2,3,13
WV - Webster County,Webster County,WV,3,4,1,1,2,4,15
WV - Lewis County,Lewis County,WV,3,2,1,1,2,4,13
WV - Pocahontas County,Pocahontas County,WV,1,1,3,1,2,3,11
WV - McDowell County,McDowell County,WV,3,1,1,1,2,4,12
WV - Wyoming County,Wyoming County,WV,3,1,1,1,2,4,12
WY - Natrona County,Natrona County,WY,4,1,3,1,7,4,20
WY - Sheridan County,Sheridan County,WY,6,1,4,1,6,4,22
WY - Fremont County,Fremont County,WY,4,1,3,1,6,4,19
WY - Park County,Park County,WY,4,1,3,1,6,4,19
WY - Platte County,Platte County,WY,6,1,3,1,6,4,21
WY - Big Horn County,Big Horn County,WY,4,1,3,1,6,4,19
WY - Niobrara County,Niobrara County,WY,6,1,4,1,4,4,20
WY - Washakie County,Washakie County,WY,4,1,3,1,6,4,19
WY - Albany County,Albany County,WY,3,1,3,1,6,4,18
WY - Converse County,Converse County,WY,6,1,1,1,6,4,19
WY - Crook County,Crook County,WY,4,1,1,1,7,4,18
WY - Hot Springs County,Hot Springs County,WY,6,1,3,1,4,4,19
WY - Johnson County,Johnson County,WY,4,1,1,1,7,4,18
WY - Campbell County,Campbell County,WY,4,1,1,1,6,4,17
WY - Carbon County,Carbon County,WY,3,1,1,1,7,4,17
WY - Goshen County,Goshen County,WY,6,1,4,1,2,4,18
WY - Weston County,Weston County,WY,4,1,1,1,6,4,17
WY - Sweetwater County,Sweetwater County,WY,3,1,1,1,6,4,16
WY - Laramie County,Laramie County,WY,3,1,3,1,3,4,15
WY - Lincoln County,Lincoln County,WY,3,1,1,1,6,4,16
WY - Sublette County,Sublette County,WY,3,1,1,1,6,4,16
WY - Teton County,Teton County,WY,3,1,1,1,6,4,16
WY - Uinta County,Uinta County,WY,3,1,1,1,4,4,14
