County,Heat,Wet Bulb,Farm Crop Yields,Sea Level Rise,Very Large Fires,Economic Damages,Total Risk Score
"Mobile County, AL",6,7,8,4,2,7,34
"Clarke County, AL",7,5,9,1,1,7,30
"Escambia County, AL",6,5,8,1,1,8,29
"Washington County, AL",6,5,8,3,1,7,30
"Baldwin County, AL",6,6,5,4,1,8,30
"Greene County, AL",7,7,8,1,1,5,29
"Monroe County, AL",6,5,8,1,1,7,28
"Pickens County, AL",7,7,8,1,1,5,29
"Sumter County, AL",7,7,8,1,1,5,29
"Autauga County, AL",7,4,8,1,1,6,27
"Butler County, AL",6,4,8,1,1,7,27
"Choctaw County, AL",7,5,8,1,1,6,28
"Conecuh County, AL",6,4,8,1,1,7,27
"Elmore County, AL",7,4,8,1,1,6,27
"Lowndes County, AL",7,6,8,1,1,5,28
"Marengo County, AL",7,5,8,1,1,6,28
"Perry County, AL",6,4,8,1,1,7,27
"Tuscaloosa County, AL",7,6,8,1,1,5,28
"Wilcox County, AL",7,4,8,1,1,6,27
"Covington County, AL",6,4,8,1,1,6,26
"Geneva County, AL",6,2,8,1,1,7,25
"Henry County, AL",6,2,8,1,1,7,25
"Montgomery County, AL",7,5,8,1,1,5,27
"Russell County, AL",7,4,8,1,1,6,27
"Coffee County, AL",6,2,8,1,1,6,24
"Crenshaw County, AL",6,2,8,1,1,6,24
"Dallas County, AL",6,4,8,1,1,6,26
"Hale County, AL",6,4,8,1,1,6,26
"Houston County, AL",6,4,8,1,1,6,26
"Lamar County, AL",7,4,8,1,1,5,26
"Macon County, AL",6,2,8,1,1,6,24
"Shelby County, AL",6,4,8,1,2,5,26
"Bibb County, AL",6,4,8,1,1,5,25
"Bullock County, AL",6,2,8,1,1,6,24
"Chilton County, AL",6,4,8,1,1,6,26
"Coosa County, AL",6,1,8,1,1,6,23
"Fayette County, AL",7,2,8,1,1,5,24
"Morgan County, AL",7,5,7,1,1,5,26
"Pike County, AL",6,4,8,1,1,5,25
"St. Clair County, AL",6,2,8,1,2,6,25
"Walker County, AL",6,2,8,1,2,5,24
"Barbour County, AL",6,2,8,1,1,5,23
"Blount County, AL",6,2,7,1,2,6,24
"Cullman County, AL",6,4,7,1,2,5,25
"Dale County, AL",6,2,8,1,1,5,23
"Lauderdale County, AL",6,4,8,1,1,5,25
"Lawrence County, AL",6,4,8,1,1,5,25
"Madison County, AL",7,4,6,1,2,5,25
"Marion County, AL",7,2,8,1,1,5,24
"Tallapoosa County, AL",6,2,8,1,1,5,23
"Clay County, AL",6,2,8,1,1,5,23
"Colbert County, AL",6,2,8,1,1,5,23
"Franklin County, AL",6,4,7,1,1,5,24
"Jefferson County, AL",6,2,7,1,2,5,23
"Talladega County, AL",6,2,8,1,1,5,23
"Calhoun County, AL",6,2,6,1,2,5,22
"Cleburne County, AL",6,2,6,1,2,5,22
"Etowah County, AL",6,2,6,1,2,5,22
"Limestone County, AL",6,4,6,1,1,5,23
"Chambers County, AL",4,1,8,1,1,5,20
"Jackson County, AL",6,2,5,1,2,5,21
"Randolph County, AL",4,1,8,1,1,5,20
"Winston County, AL",6,2,6,1,1,5,21
"Lee County, AL",4,1,7,1,1,5,19
"Marshall County, AL",4,2,5,1,2,5,19
"Cherokee County, AL",4,1,4,1,2,5,17
"DeKalb County, AL",4,1,4,1,2,5,17
"Franklin County, AR",7,7,9,1,2,4,30
"White County, AR",7,2,8,1,6,4,28
"Grant County, AR",7,9,8,1,1,4,30
"Lawrence County, AR",6,7,8,1,2,4,28
"Mississippi County, AR",7,7,8,1,1,5,29
"Pulaski County, AR",7,7,8,1,1,4,28
"Clark County, AR",6,6,9,1,1,4,27
"Little River County, AR",7,4,9,1,1,5,27
"Logan County, AR",7,4,9,1,2,4,27
"Miller County, AR",7,4,9,1,1,5,27
"Randolph County, AR",6,6,8,1,2,4,27
"Conway County, AR",7,4,8,1,2,4,26
"Craighead County, AR",7,6,8,1,1,4,27
"Crawford County, AR",7,4,8,1,2,4,26
"Crittenden County, AR",7,6,7,1,1,5,27
"Faulkner County, AR",7,4,8,1,2,4,26
"Hempstead County, AR",7,2,9,1,1,5,25
"Hot Spring County, AR",7,4,8,1,2,4,26
"Jefferson County, AR",6,7,8,1,1,4,27
"Lonoke County, AR",6,7,8,1,1,4,27
"Poinsett County, AR",7,6,8,1,1,4,27
"Saline County, AR",6,4,8,1,2,5,26
"Sebastian County, AR",7,4,8,1,2,4,26
"Chicot County, AR",9,4,7,1,1,5,27
"Cleburne County, AR",6,2,8,1,3,4,24
"Cross County, AR",6,6,8,1,1,4,26
"Desha County, AR",7,5,7,1,1,5,26
"Drew County, AR",7,2,8,1,1,5,24
"Fulton County, AR",6,4,8,1,2,4,25
"Johnson County, AR",7,2,8,1,2,4,24
"Lafayette County, AR",7,2,8,1,1,5,24
"Nevada County, AR",6,2,10,1,1,4,24
"Pope County, AR",7,2,8,1,2,4,24
"Yell County, AR",7,2,8,1,2,4,24
"Ashley County, AR",7,2,8,1,1,5,24
"Baxter County, AR",6,2,8,1,2,4,23
"Benton County, AR",6,2,8,1,2,4,23
"Clay County, AR",6,5,8,1,1,4,25
"Greene County, AR",6,4,8,1,1,4,24
"Independence County, AR",6,2,8,1,2,4,23
"Lee County, AR",7,4,8,1,1,4,25
"Perry County, AR",6,2,8,1,2,4,23
"St. Francis County, AR",6,4,8,1,1,4,24
"Washington County, AR",6,2,8,1,3,4,24
"Woodruff County, AR",7,4,8,1,1,4,25
"Arkansas County, AR",7,2,7,1,1,5,23
"Cleveland County, AR",6,2,8,1,1,4,22
"Izard County, AR",6,1,8,1,2,4,22
"Lincoln County, AR",7,2,7,1,1,5,23
"Prairie County, AR",7,2,8,1,1,4,23
"Jackson County, AR",6,2,8,1,1,4,22
"Monroe County, AR",7,2,7,1,1,4,22
"Phillips County, AR",7,2,7,1,1,4,22
"Dallas County, AR",6,7,1,1,1,4,20
"Bradley County, AR",7,4,1,1,1,5,19
"Garland County, AR",7,4,1,1,2,4,19
"Ouachita County, AR",7,4,1,1,1,5,19
"Van Buren County, AR",6,5,1,1,2,4,19
"Columbia County, AR",7,2,1,1,1,5,17
"Howard County, AR",7,4,1,1,1,4,18
"Montgomery County, AR",6,4,1,1,2,4,18
"Pike County, AR",7,4,1,1,1,4,18
"Polk County, AR",7,2,1,1,2,4,17
"Scott County, AR",7,2,1,1,2,4,17
"Sharp County, AR",6,4,1,1,2,4,18
"Union County, AR",7,2,1,1,1,5,17
"Calhoun County, AR",6,2,1,1,1,5,16
"Searcy County, AR",6,2,1,1,2,4,16
"Sevier County, AR",7,2,1,1,1,4,16
"Carroll County, AR",4,2,1,1,2,4,14
"Madison County, AR",4,2,1,1,2,4,14
"Stone County, AR",6,1,1,1,2,4,15
"Boone County, AR",4,1,1,1,2,4,13
"Marion County, AR",4,1,1,1,2,4,13
"Newton County, AR",3,1,1,1,2,4,12
"Pinal County, AZ",10,6,8,1,6,7,38
"Graham County, AZ",10,2,8,1,8,6,35
"Cochise County, AZ",7,2,8,1,9,6,33
"Mohave County, AZ",10,6,1,1,9,7,34
"Maricopa County, AZ",10,7,8,1,1,6,33
"Yuma County, AZ",10,7,8,1,1,6,33
"Gila County, AZ",10,5,1,1,7,5,29
"Yavapai County, AZ",4,1,7,1,7,5,25
"Greenlee County, AZ",7,1,6,1,6,5,26
"Pima County, AZ",10,2,1,1,7,6,27
"La Paz County, AZ",10,7,1,1,1,7,27
"Navajo County, AZ",7,1,4,1,6,5,24
"Coconino County, AZ",3,1,1,1,9,5,20
"Santa Cruz County, AZ",9,1,1,1,6,5,23
"Apache County, AZ",4,1,1,1,6,5,18
"Fresno County, CA",9,4,8,1,8,5,35
"Tehama County, CA",9,4,8,1,7,5,34
"Shasta County, CA",7,4,6,1,9,5,32
"Imperial County, CA",10,7,8,1,1,5,32
"Madera County, CA",7,2,8,1,6,5,29
"Amador County, CA",7,2,8,1,6,5,29
"Butte County, CA",6,2,8,1,6,5,28
"Riverside County, CA",10,6,8,1,1,5,31
"El Dorado County, CA",4,2,6,1,8,5,26
"San Bernardino County, CA",10,5,8,1,1,5,30
"Merced County, CA",9,2,4,1,6,5,27
"Nevada County, CA",4,2,6,1,7,5,25
"Placer County, CA",4,2,5,1,7,5,24
"Tulare County, CA",9,2,8,1,1,5,26
"Glenn County, CA",7,2,8,1,1,5,24
"Kings County, CA",9,2,8,1,1,5,26
"Los Angeles County, CA",4,2,4,3,6,5,24
"Mendocino County, CA",4,1,3,3,8,5,24
"Modoc County, CA",4,1,4,1,9,4,23
"Santa Barbara County, CA",7,2,3,3,6,4,25
"Trinity County, CA",7,4,1,1,9,4,26
"Tuolumne County, CA",4,1,5,1,7,5,23
"Yolo County, CA",9,2,4,4,3,5,27
"Colusa County, CA",7,2,8,1,1,5,24
"San Diego County, CA",3,1,4,4,6,5,23
"Solano County, CA",9,2,3,4,3,5,26
"Sonoma County, CA",6,5,3,4,3,5,26
"Santa Clara County, CA",3,2,3,4,6,5,23
"Siskiyou County, CA",6,1,1,1,10,4,23
"Lassen County, CA",4,1,1,1,10,4,21
"Sacramento County, CA",7,2,4,4,1,5,23
"San Benito County, CA",4,2,3,1,6,5,21
"San Joaquin County, CA",7,2,4,4,1,5,23
"San Luis Obispo County, CA",3,1,3,3,6,5,21
"Sutter County, CA",7,2,6,1,1,5,22
"Yuba County, CA",4,2,8,1,1,5,21
"Kern County, CA",4,1,8,1,1,5,20
"Orange County, CA",4,2,3,4,3,5,21
"Plumas County, CA",4,1,1,1,9,4,20
"Lake County, CA",7,1,1,1,6,5,21
"Napa County, CA",4,1,3,3,4,5,20
"Stanislaus County, CA",7,2,4,1,1,5,20
"Ventura County, CA",3,2,1,3,6,5,20
"Contra Costa County, CA",6,1,3,3,2,5,20
"Inyo County, CA",10,4,1,1,1,5,22
"Mariposa County, CA",4,1,1,1,6,5,18
"San Mateo County, CA",3,1,3,7,2,4,20
"Sierra County, CA",4,1,1,1,7,4,18
"Calaveras County, CA",3,1,1,1,6,5,17
"Monterey County, CA",4,2,3,3,1,5,18
"Alameda County, CA",6,1,1,4,3,4,19
"Mono County, CA",3,1,1,1,6,4,16
"Alpine County, CA",3,1,1,1,6,4,16
"Humboldt County, CA",1,1,3,4,1,4,14
"Marin County, CA",4,1,1,4,1,4,15
"San Francisco County, CA",3,2,1,4,1,4,15
"Del Norte County, CA",1,1,1,4,1,4,12
"Santa Cruz County, CA",3,1,1,3,1,4,13
"Mesa County, CO",7,2,4,1,7,4,25
"Baca County, CO",7,2,6,1,3,5,24
"Prowers County, CO",7,2,7,1,2,5,24
"Bent County, CO",7,2,6,1,2,5,23
"Cheyenne County, CO",7,2,5,1,2,5,22
"Kiowa County, CO",7,2,5,1,2,5,22
"Otero County, CO",7,1,5,1,2,5,21
"Crowley County, CO",7,1,4,1,2,5,20
"Larimer County, CO",4,1,3,1,6,4,19
"Las Animas County, CO",4,1,3,1,6,4,19
"Montezuma County, CO",4,1,3,1,6,4,19
"Montrose County, CO",3,1,3,1,6,4,18
"Boulder County, CO",4,1,3,1,5,4,18
"Delta County, CO",4,1,3,1,5,4,18
"Kit Carson County, CO",7,2,4,1,1,4,19
"La Plata County, CO",3,1,3,1,6,4,18
"Moffat County, CO",6,1,1,1,6,4,19
"Pueblo County, CO",7,1,3,1,3,4,19
"Dolores County, CO",4,1,3,1,4,4,17
"Garfield County, CO",4,1,1,1,6,4,17
"Logan County, CO",6,2,4,1,1,4,18
"Rio Blanco County, CO",4,1,1,1,6,4,17
"Adams County, CO",6,1,3,1,2,4,17
"Arapahoe County, CO",6,1,3,1,2,4,17
"Broomfield County, CO",6,1,3,1,2,4,17
"Jefferson County, CO",3,1,3,1,4,4,16
"Lincoln County, CO",4,1,3,1,3,4,16
"Morgan County, CO",6,1,4,1,1,4,17
"Sedgwick County, CO",6,1,4,1,1,4,17
"Washington County, CO",6,1,4,1,1,4,17
"Weld County, CO",4,1,3,1,3,4,16
"Yuma County, CO",6,1,4,1,1,4,17
"Archuleta County, CO",3,1,1,1,6,4,16
"Douglas County, CO",3,1,3,1,3,4,15
"Elbert County, CO",4,1,3,1,2,4,15
"Fremont County, CO",3,1,1,1,6,4,16
"Gunnison County, CO",1,1,1,1,6,4,14
"Phillips County, CO",4,1,4,1,1,4,15
"Routt County, CO",3,1,1,1,6,4,16
"El Paso County, CO",3,1,3,1,2,4,14
"Huerfano County, CO",4,1,1,1,4,4,15
"Saguache County, CO",3,1,1,1,5,4,15
"Eagle County, CO",3,1,1,1,4,4,14
"San Miguel County, CO",3,1,1,1,4,4,14
"Conejos County, CO",3,1,1,1,3,4,13
"Costilla County, CO",3,1,1,1,3,4,13
"Custer County, CO",3,1,1,1,3,4,13
"Denver County, CO",4,1,1,1,2,4,13
"Jackson County, CO",3,1,1,1,3,4,13
"Pitkin County, CO",3,1,1,1,3,4,13
"Teller County, CO",3,1,1,1,3,4,13
"Alamosa County, CO",3,1,1,1,2,4,12
"Chaffee County, CO",1,1,1,1,3,4,11
"Mineral County, CO",1,1,1,1,3,4,11
"Ouray County, CO",1,1,1,1,3,4,11
"Rio Grande County, CO",1,1,1,1,3,4,11
"Clear Creek County, CO",1,1,1,1,2,4,10
"Gilpin County, CO",1,1,1,1,2,4,10
"Hinsdale County, CO",3,1,1,1,3,2,11
"Lake County, CO",1,1,1,1,2,4,10
"Park County, CO",1,1,1,1,5,1,10
"San Juan County, CO",1,1,1,1,2,4,10
"Grand County, CO",1,1,1,1,3,2,9
"Summit County, CO",1,1,1,1,2,3,9
"Fairfield County, CT",3,5,1,4,1,5,19
"Middlesex County, CT",3,5,1,4,1,4,18
"New Haven County, CT",3,5,1,4,1,4,18
"Hartford County, CT",4,5,1,1,1,4,16
"New London County, CT",3,2,1,4,1,4,15
"Tolland County, CT",3,4,1,1,1,4,14
"Windham County, CT",3,4,1,1,1,4,14
"Litchfield County, CT",3,2,1,1,1,4,12
"District of Columbia, DC",6,2,1,3,1,4,17
"Kent County, DE",4,4,5,4,3,4,24
"Sussex County, DE",4,4,5,6,1,5,25
"New Castle County, DE",4,2,4,3,1,4,18
"Wakulla County, FL",7,9,8,4,1,9,38
"Marion County, FL",9,4,8,3,4,8,36
"Miami-Dade County, FL",4,5,8,4,6,8,35
"Palm Beach County, FL",4,4,8,4,6,8,34
"Dixie County, FL",7,6,7,4,1,10,35
"St. Johns County, FL",6,6,8,4,2,8,34
"Taylor County, FL",7,6,8,4,1,8,34
"Volusia County, FL",4,6,8,4,3,9,34
"Duval County, FL",6,6,7,4,3,8,34
"Glades County, FL",9,1,8,3,3,9,33
"Levy County, FL",6,4,8,4,1,10,33
"Pasco County, FL",9,5,8,3,3,7,35
"Gilchrist County, FL",6,5,8,3,2,8,32
"Lafayette County, FL",7,5,8,1,2,8,31
"Lake County, FL",6,2,8,4,3,8,31
"Putnam County, FL",4,2,8,4,3,9,30
"Baker County, FL",6,4,8,1,3,8,30
"Collier County, FL",6,4,8,4,1,8,31
"Flagler County, FL",4,4,8,4,2,8,30
"Highlands County, FL",9,1,8,1,3,8,30
"Leon County, FL",7,7,8,1,1,7,31
"Madison County, FL",7,5,8,1,2,8,31
"Polk County, FL",7,2,8,1,5,6,29
"Suwannee County, FL",7,5,8,1,1,8,30
"Columbia County, FL",6,4,8,1,3,7,29
"Hamilton County, FL",7,4,8,1,1,8,29
"Jefferson County, FL",7,7,5,1,2,8,30
"Liberty County, FL",4,5,8,3,1,8,29
"Union County, FL",6,4,8,1,2,8,29
"Alachua County, FL",6,2,8,1,3,7,27
"Bay County, FL",4,4,8,4,1,7,28
"Bradford County, FL",6,2,8,1,2,8,27
"Clay County, FL",6,5,3,4,3,9,30
"Gadsden County, FL",7,4,8,1,1,7,28
"Hardee County, FL",9,2,8,1,3,5,28
"Hillsborough County, FL",6,4,8,4,3,5,30
"Charlotte County, FL",9,6,1,4,2,8,30
"Monroe County, FL",4,5,1,7,4,8,29
"Broward County, FL",4,4,1,4,6,8,27
"DeSoto County, FL",9,5,1,4,2,8,29
"Escambia County, FL",4,7,3,3,1,8,26
"Franklin County, FL",4,6,1,4,2,10,27
"Lee County, FL",9,6,1,4,1,8,29
"Nassau County, FL",6,6,1,4,3,8,28
"Santa Rosa County, FL",4,7,3,4,1,8,27
"Walton County, FL",6,4,3,4,3,8,28
"Washington County, FL",4,2,6,3,1,9,25
"Citrus County, FL",9,4,1,4,1,9,28
"Hernando County, FL",9,5,1,4,1,8,28
"Martin County, FL",4,6,1,4,3,8,26
"Calhoun County, FL",4,2,5,1,1,9,22
"Jackson County, FL",4,2,8,1,1,6,22
"Okaloosa County, FL",6,5,3,3,2,7,26
"Hendry County, FL",6,4,1,1,3,9,24
"Okeechobee County, FL",9,2,1,1,3,8,24
"Pinellas County, FL",6,7,1,4,1,6,25
"St. Lucie County, FL",4,5,1,4,2,8,24
"Sumter County, FL",9,4,1,1,2,8,25
"Gulf County, FL",4,4,1,3,1,10,23
"Holmes County, FL",4,2,4,1,1,8,20
"Brevard County, FL",4,1,1,4,3,8,21
"Orange County, FL",7,2,1,3,3,6,22
"Osceola County, FL",6,2,1,1,3,8,21
"Seminole County, FL",7,4,1,3,2,6,23
"Indian River County, FL",4,1,1,4,2,8,20
"Sarasota County, FL",7,4,1,4,1,5,22
"Manatee County, FL",7,4,1,4,1,4,21
"Camden County, GA",6,9,8,4,2,8,37
"Charlton County, GA",9,6,8,1,3,8,35
"Liberty County, GA",7,9,9,4,2,6,37
"Effingham County, GA",6,6,9,3,3,7,34
"Bryan County, GA",7,2,8,4,3,8,32
"Glynn County, GA",6,5,8,6,1,8,34
"Ware County, GA",7,5,9,1,3,7,32
"Brantley County, GA",7,4,9,1,2,8,31
"Long County, GA",7,4,8,1,3,8,31
"Echols County, GA",7,4,8,1,2,8,30
"Pierce County, GA",7,2,9,1,3,6,28
"Screven County, GA",7,2,8,1,3,6,27
"Appling County, GA",7,4,8,1,3,5,28
"Atkinson County, GA",7,2,9,1,2,6,27
"Bacon County, GA",7,2,9,1,3,5,27
"Berrien County, GA",7,2,9,1,2,6,27
"Clinch County, GA",7,2,8,1,3,6,27
"Evans County, GA",7,2,9,1,1,6,26
"Lanier County, GA",7,2,8,1,2,6,26
"McIntosh County, GA",6,9,1,4,2,9,31
"Wayne County, GA",7,4,8,1,3,5,28
"Baker County, GA",7,4,8,1,1,6,27
"Candler County, GA",7,2,8,1,1,6,25
"Cook County, GA",7,2,9,1,1,6,26
"Grady County, GA",7,5,8,1,1,5,27
"Jeff Davis County, GA",7,2,9,1,2,5,26
"Jenkins County, GA",6,2,9,1,1,6,25
"Montgomery County, GA",7,2,8,1,1,6,25
"Seminole County, GA",7,2,8,1,1,7,26
"Thomas County, GA",7,4,8,1,1,6,27
"Treutlen County, GA",7,2,9,1,1,6,26
"Wheeler County, GA",7,2,9,1,1,6,26
"Bulloch County, GA",7,2,8,1,1,6,25
"Coffee County, GA",7,2,9,1,1,5,25
"Decatur County, GA",7,2,8,1,1,6,25
"Johnson County, GA",7,2,8,1,1,6,25
"Lowndes County, GA",7,2,7,1,3,6,26
"Tattnall County, GA",7,2,8,1,1,6,25
"Worth County, GA",7,2,8,1,1,6,25
"Ben Hill County, GA",6,2,9,1,1,5,24
"Bibb County, GA",7,2,8,1,1,5,24
"Brooks County, GA",7,4,5,1,1,7,25
"Burke County, GA",7,2,8,1,1,5,24
"Catoosa County, GA",6,2,8,1,2,5,24
"Clay County, GA",6,2,8,1,1,6,24
"Crawford County, GA",7,2,8,1,1,5,24
"Dougherty County, GA",7,2,8,1,1,5,24
"Houston County, GA",7,2,8,1,1,5,24
"Laurens County, GA",7,2,8,1,1,5,24
"Lee County, GA",7,2,8,1,1,5,24
"Mitchell County, GA",7,2,8,1,1,5,24
"Peach County, GA",7,2,8,1,1,5,24
"Richmond County, GA",7,2,8,1,1,5,24
"Telfair County, GA",6,2,9,1,1,5,24
"Toombs County, GA",7,2,8,1,1,5,24
"Twiggs County, GA",7,2,8,1,1,5,24
"Wilkinson County, GA",7,2,8,1,1,5,24
"Bleckley County, GA",6,2,8,1,1,5,23
"Colquitt County, GA",7,1,8,1,1,5,23
"Dodge County, GA",6,2,8,1,1,5,23
"Early County, GA",6,2,8,1,1,5,23
"Emanuel County, GA",6,2,8,1,1,5,23
"Glascock County, GA",6,2,8,1,1,5,23
"Greene County, GA",6,2,8,1,1,5,23
"Irwin County, GA",6,2,8,1,1,5,23
"Jefferson County, GA",6,2,8,1,1,5,23
"Marion County, GA",6,1,8,1,1,6,23
"Miller County, GA",6,2,8,1,1,6,24
"Pulaski County, GA",6,2,8,1,1,5,23
"Tift County, GA",6,1,9,1,1,5,23
"Warren County, GA",6,2,8,1,1,5,23
"Washington County, GA",6,2,8,1,1,5,23
"Webster County, GA",6,2,8,1,1,5,23
"Whitfield County, GA",6,2,8,1,2,5,24
"Wilcox County, GA",6,2,8,1,1,5,23
"Calhoun County, GA",6,1,8,1,1,5,22
"Chatham County, GA",6,2,1,6,3,7,25
"Columbia County, GA",6,2,8,1,1,5,23
"Crisp County, GA",6,1,8,1,1,5,22
"Dooly County, GA",6,1,8,1,1,5,22
"Fayette County, GA",6,1,8,1,1,5,22
"Harris County, GA",7,2,7,1,1,5,23
"Jasper County, GA",6,1,8,1,1,5,22
"Macon County, GA",6,1,8,1,1,5,22
"Rockdale County, GA",6,1,8,1,1,5,22
"Schley County, GA",6,1,8,1,1,5,22
"Stewart County, GA",6,1,8,1,1,5,22
"Sumter County, GA",6,1,8,1,1,5,22
"Talbot County, GA",6,1,8,1,1,5,22
"Taylor County, GA",6,2,8,1,1,5,23
"Terrell County, GA",6,1,8,1,1,5,22
"Turner County, GA",6,1,8,1,1,5,22
"Walton County, GA",6,1,8,1,1,5,22
"Wilkes County, GA",6,1,8,1,1,5,22
"Barrow County, GA",6,1,8,1,1,5,22
"Carroll County, GA",4,1,8,1,1,5,20
"Dade County, GA",4,2,7,1,2,5,21
"Haralson County, GA",4,1,8,1,2,5,21
"Heard County, GA",4,1,8,1,1,5,20
"Meriwether County, GA",6,1,8,1,1,5,22
"Monroe County, GA",6,1,8,1,1,5,22
"Putnam County, GA",7,2,6,1,1,5,22
"Randolph County, GA",6,1,8,1,1,5,22
"Troup County, GA",4,1,8,1,1,5,20
"Upson County, GA",6,1,8,1,1,5,22
"Walker County, GA",6,2,6,1,2,5,22
"Floyd County, GA",6,2,5,1,2,5,21
"Gwinnett County, GA",4,1,8,1,1,5,20
"Henry County, GA",6,1,7,1,1,5,21
"Lamar County, GA",6,1,7,1,1,5,21
"Butts County, GA",6,1,6,1,1,5,20
"Gordon County, GA",6,2,4,1,2,5,20
"Morgan County, GA",6,1,6,1,1,5,20
"Newton County, GA",6,1,6,1,1,5,20
"Oglethorpe County, GA",6,1,6,1,1,5,20
"Paulding County, GA",6,1,6,1,1,5,20
"Pike County, GA",6,1,6,1,1,5,20
"Polk County, GA",6,1,5,1,2,5,20
"Spalding County, GA",6,1,6,1,1,5,20
"Bartow County, GA",6,1,4,1,2,5,19
"Chattooga County, GA",4,1,5,1,2,5,18
"Cherokee County, GA",3,1,7,1,1,5,18
"Elbert County, GA",4,1,6,1,1,5,18
"Murray County, GA",4,1,5,1,2,5,18
"Coweta County, GA",4,1,5,1,1,5,17
"Douglas County, GA",6,1,4,1,1,5,18
"Fulton County, GA",6,1,4,1,1,5,18
"Hart County, GA",4,1,5,1,1,5,17
"Oconee County, GA",6,1,4,1,1,5,18
"Franklin County, GA",4,1,4,1,1,5,16
"Madison County, GA",6,1,3,1,1,5,17
"Quitman County, GA",6,2,1,1,1,6,17
"Stephens County, GA",3,1,5,1,1,5,16
"Baldwin County, GA",7,2,1,1,1,5,17
"Banks County, GA",4,1,3,1,1,5,15
"Chattahoochee County, GA",7,2,1,1,1,5,17
"Dawson County, GA",3,1,4,1,1,5,15
"Forsyth County, GA",4,1,3,1,1,5,15
"Hall County, GA",4,1,3,1,1,5,15
"Jackson County, GA",4,1,3,1,1,5,15
"Jones County, GA",7,2,1,1,1,5,17
"Muscogee County, GA",7,2,1,1,1,5,17
"Pickens County, GA",3,1,5,1,1,4,15
"Union County, GA",4,1,3,1,2,4,15
"Fannin County, GA",3,1,3,1,2,4,14
"Hancock County, GA",6,2,1,1,1,5,16
"Lincoln County, GA",6,2,1,1,1,5,16
"Lumpkin County, GA",4,1,3,1,1,4,14
"Rabun County, GA",3,1,3,1,2,4,14
"Taliaferro County, GA",6,2,1,1,1,5,16
"Towns County, GA",3,1,3,1,2,4,14
"Clarke County, GA",6,1,1,1,1,5,15
"Clayton County, GA",6,1,1,1,1,5,15
"Cobb County, GA",6,1,1,1,1,5,15
"DeKalb County, GA",6,1,1,1,1,5,15
"Gilmer County, GA",3,1,3,1,1,4,13
"Habersham County, GA",3,1,3,1,1,4,13
"McDuffie County, GA",6,1,1,1,1,5,15
"White County, GA",3,1,3,1,1,4,13
"Van Buren County, IA",6,5,5,1,2,5,24
"Jefferson County, IA",4,6,5,1,2,4,22
"Davis County, IA",4,4,5,1,2,5,21
"Lee County, IA",4,5,5,1,1,5,21
"Muscatine County, IA",4,6,4,1,1,5,21
"Appanoose County, IA",4,4,4,1,2,5,20
"Calhoun County, IA",4,5,4,1,1,5,20
"Decatur County, IA",4,4,4,1,2,5,20
"Henry County, IA",4,4,4,1,2,5,20
"Jasper County, IA",4,5,4,1,1,5,20
"Louisa County, IA",4,5,4,1,1,5,20
"Lucas County, IA",4,4,4,1,2,5,20
"Monroe County, IA",4,4,4,1,2,5,20
"Polk County, IA",4,5,4,1,1,5,20
"Pottawattamie County, IA",6,2,5,1,1,5,20
"Wapello County, IA",4,4,5,1,2,4,20
"Washington County, IA",4,5,4,1,1,5,20
"Wayne County, IA",4,4,4,1,2,5,20
"Audubon County, IA",4,4,4,1,1,5,19
"Black Hawk County, IA",4,6,3,1,1,4,19
"Boone County, IA",4,4,4,1,1,5,19
"Bremer County, IA",4,6,3,1,1,4,19
"Carroll County, IA",4,4,4,1,1,5,19
"Cedar County, IA",4,5,3,1,1,5,19
"Crawford County, IA",4,4,4,1,1,5,19
"Dallas County, IA",4,4,4,1,1,5,19
"Des Moines County, IA",4,5,4,1,1,4,19
"Fremont County, IA",4,2,5,1,1,5,18
"Greene County, IA",4,4,4,1,1,5,19
"Hamilton County, IA",4,5,3,1,1,5,19
"Harrison County, IA",4,2,5,1,1,5,18
"Humboldt County, IA",4,5,3,1,1,5,19
"Ida County, IA",4,4,4,1,1,5,19
"Johnson County, IA",4,4,4,1,1,5,19
"Keokuk County, IA",4,4,4,1,1,5,19
"Mahaska County, IA",4,4,4,1,1,5,19
"Marion County, IA",4,4,4,1,1,5,19
"Mills County, IA",4,2,5,1,1,5,18
"Page County, IA",4,2,5,1,1,5,18
"Pocahontas County, IA",4,5,3,1,1,5,19
"Scott County, IA",4,5,4,1,1,4,19
"Shelby County, IA",4,4,4,1,1,5,19
"Story County, IA",4,5,4,1,1,4,19
"Warren County, IA",4,4,4,1,1,5,19
"Webster County, IA",4,5,4,1,1,4,19
"Adair County, IA",4,2,4,1,1,5,17
"Adams County, IA",4,2,4,1,1,5,17
"Benton County, IA",4,4,3,1,1,5,18
"Cerro Gordo County, IA",4,5,3,1,1,4,18
"Clarke County, IA",4,1,4,1,2,5,17
"Clay County, IA",4,5,3,1,1,4,18
"Clinton County, IA",3,4,3,1,2,5,18
"Franklin County, IA",4,5,3,1,1,4,18
"Grundy County, IA",4,5,3,1,1,4,18
"Guthrie County, IA",4,2,4,1,1,5,17
"Hardin County, IA",4,5,3,1,1,4,18
"Iowa County, IA",4,4,3,1,1,5,18
"Jackson County, IA",4,4,3,1,2,4,18
"Madison County, IA",4,2,4,1,1,5,17
"Marshall County, IA",4,5,3,1,1,4,18
"Monona County, IA",4,2,4,1,1,5,17
"Montgomery County, IA",4,2,4,1,1,5,17
"Plymouth County, IA",4,2,4,1,1,5,17
"Ringgold County, IA",4,2,4,1,1,5,17
"Sac County, IA",4,4,3,1,1,5,18
"Sioux County, IA",4,4,4,1,1,4,18
"Tama County, IA",4,5,3,1,1,4,18
"Taylor County, IA",4,2,4,1,1,5,17
"Union County, IA",4,2,4,1,1,5,17
"Wright County, IA",4,5,3,1,1,4,18
"Buchanan County, IA",3,5,3,1,1,4,17
"Buena Vista County, IA",3,5,3,1,1,4,17
"Butler County, IA",3,5,3,1,1,4,17
"Cass County, IA",4,2,4,1,1,4,16
"Cherokee County, IA",4,4,3,1,1,4,17
"Clayton County, IA",4,4,3,1,1,4,17
"Delaware County, IA",3,5,3,1,1,4,17
"Hancock County, IA",3,5,3,1,1,4,17
"Jones County, IA",4,4,3,1,1,4,17
"Kossuth County, IA",3,5,3,1,1,4,17
"Linn County, IA",4,4,3,1,1,4,17
"Mitchell County, IA",3,5,3,1,1,4,17
"Poweshiek County, IA",4,4,3,1,1,4,17
"Winnebago County, IA",3,5,3,1,1,4,17
"Winneshiek County, IA",4,4,3,1,1,4,17
"Woodbury County, IA",4,2,4,1,1,4,16
"Chickasaw County, IA",3,4,3,1,1,4,16
"Dubuque County, IA",3,4,3,1,1,4,16
"Emmet County, IA",3,4,3,1,1,4,16
"Fayette County, IA",3,4,3,1,1,4,16
"Floyd County, IA",3,4,3,1,1,4,16
"Howard County, IA",3,4,3,1,1,4,16
"Lyon County, IA",4,2,3,1,1,4,15
"O'Brien County, IA",4,2,3,1,1,4,15
"Osceola County, IA",4,2,3,1,1,4,15
"Palo Alto County, IA",3,4,3,1,1,4,16
"Worth County, IA",3,4,3,1,1,4,16
"Allamakee County, IA",3,2,3,1,1,4,14
"Dickinson County, IA",4,1,3,1,1,4,14
"Owyhee County, ID",7,1,6,1,10,5,30
"Elmore County, ID",6,1,6,1,9,5,28
"Ada County, ID",6,2,6,1,7,5,27
"Gooding County, ID",4,1,6,1,6,5,23
"Twin Falls County, ID",4,1,5,1,7,4,22
"Cassia County, ID",4,1,4,1,7,4,21
"Lincoln County, ID",4,1,4,1,6,5,21
"Custer County, ID",3,1,4,1,7,4,20
"Camas County, ID",4,1,3,1,6,4,19
"Canyon County, ID",6,1,7,1,1,5,21
"Franklin County, ID",6,1,3,1,6,4,21
"Idaho County, ID",4,1,1,1,9,4,20
"Minidoka County, ID",4,1,4,1,6,4,20
"Payette County, ID",6,1,7,1,1,5,21
"Adams County, ID",3,1,3,1,6,4,18
"Bingham County, ID",4,1,3,1,6,4,19
"Gem County, ID",6,1,6,1,1,5,20
"Washington County, ID",7,1,5,1,1,5,20
"Blaine County, ID",4,1,1,1,7,4,18
"Boise County, ID",4,1,1,1,7,4,18
"Bonneville County, ID",3,1,3,1,6,4,18
"Butte County, ID",4,1,1,1,7,4,18
"Clearwater County, ID",6,1,1,1,6,4,19
"Jerome County, ID",6,1,5,1,1,5,19
"Lemhi County, ID",4,1,1,1,7,4,18
"Shoshone County, ID",4,1,1,1,6,4,17
"Valley County, ID",3,1,1,1,7,4,17
"Bonner County, ID",4,1,1,1,6,4,17
"Clark County, ID",3,1,1,1,6,4,16
"Kootenai County, ID",4,1,1,1,6,4,17
"Nez Perce County, ID",3,1,1,1,6,5,17
"Bear Lake County, ID",3,1,1,1,6,4,16
"Boundary County, ID",4,1,1,1,4,4,15
"Jefferson County, ID",4,1,3,1,1,4,14
"Oneida County, ID",4,1,3,1,1,4,14
"Power County, ID",4,1,3,1,1,4,14
"Fremont County, ID",3,1,1,1,3,4,13
"Teton County, ID",3,1,1,1,3,4,13
"Bannock County, ID",4,1,1,1,1,4,12
"Benewah County, ID",4,1,1,1,1,4,12
"Caribou County, ID",4,1,1,1,1,4,12
"Latah County, ID",4,1,1,1,1,4,12
"Lewis County, ID",3,1,1,1,1,4,11
"Madison County, ID",3,1,1,1,1,4,11
"Alexander County, IL",6,7,8,1,1,5,28
"Pulaski County, IL",6,7,8,1,1,5,28
"Gallatin County, IL",6,9,7,1,1,5,29
"Hardin County, IL",6,7,8,1,1,4,27
"Pope County, IL",6,7,8,1,1,5,28
"Union County, IL",6,7,8,1,1,5,28
"Jackson County, IL",6,7,7,1,1,5,27
"Johnson County, IL",6,6,8,1,1,5,27
"Massac County, IL",4,7,8,1,1,5,26
"St. Clair County, IL",7,6,7,1,1,5,27
"Saline County, IL",6,7,7,1,1,5,27
"White County, IL",6,9,6,1,1,5,28
"Madison County, IL",7,6,6,1,1,5,26
"Randolph County, IL",6,6,7,1,1,5,26
"Williamson County, IL",6,6,7,1,1,5,26
"Crawford County, IL",6,7,5,1,1,5,25
"Edwards County, IL",6,6,6,1,1,5,25
"Franklin County, IL",6,6,6,1,1,5,25
"Hamilton County, IL",6,6,6,1,1,5,25
"Lawrence County, IL",6,7,5,1,1,5,25
"Macon County, IL",6,7,5,1,1,5,25
"Monroe County, IL",6,5,7,1,1,5,25
"Montgomery County, IL",6,7,5,1,1,5,25
"Perry County, IL",6,6,6,1,1,5,25
"Bond County, IL",6,6,5,1,1,5,24
"Calhoun County, IL",6,4,7,1,1,5,24
"Clinton County, IL",4,6,6,1,1,5,23
"De Witt County, IL",6,7,4,1,1,5,24
"Pike County, IL",6,5,6,1,1,5,24
"Wabash County, IL",4,7,5,1,1,5,23
"Wayne County, IL",6,6,5,1,1,5,24
"Christian County, IL",4,6,5,1,1,5,22
"Clay County, IL",4,6,5,1,1,5,22
"Edgar County, IL",4,7,4,1,1,5,22
"Effingham County, IL",4,6,5,1,1,5,22
"Fayette County, IL",4,6,5,1,1,5,22
"Greene County, IL",4,5,6,1,1,5,22
"Jasper County, IL",4,6,5,1,1,5,22
"Logan County, IL",4,7,4,1,1,5,22
"Marion County, IL",4,6,5,1,1,5,22
"Marshall County, IL",4,7,4,1,1,5,22
"Piatt County, IL",4,7,4,1,1,5,22
"Putnam County, IL",4,7,4,1,1,5,22
"Richland County, IL",4,6,5,1,1,5,22
"Sangamon County, IL",4,6,5,1,1,5,22
"Washington County, IL",4,6,5,1,1,5,22
"Adams County, IL",4,5,5,1,1,5,21
"Brown County, IL",4,5,5,1,1,5,21
"Cass County, IL",4,5,5,1,1,5,21
"Champaign County, IL",4,6,4,1,1,5,21
"Clark County, IL",4,6,4,1,1,5,21
"Coles County, IL",4,6,4,1,1,5,21
"Cumberland County, IL",4,6,4,1,1,5,21
"Douglas County, IL",4,6,4,1,1,5,21
"Hancock County, IL",4,5,5,1,1,5,21
"Henderson County, IL",4,5,5,1,1,5,21
"Jefferson County, IL",4,5,5,1,1,5,21
"Jersey County, IL",4,4,6,1,1,5,21
"Kankakee County, IL",4,7,4,1,1,4,21
"Kendall County, IL",4,7,4,1,1,4,21
"Macoupin County, IL",4,5,5,1,1,5,21
"Mason County, IL",4,5,5,1,1,5,21
"Menard County, IL",4,6,4,1,1,5,21
"Morgan County, IL",4,5,5,1,1,5,21
"Moultrie County, IL",4,6,4,1,1,5,21
"Peoria County, IL",4,6,4,1,1,5,21
"Shelby County, IL",4,6,4,1,1,5,21
"Tazewell County, IL",4,6,4,1,1,5,21
"Vermilion County, IL",4,6,4,1,1,5,21
"Woodford County, IL",4,6,4,1,1,5,21
"Carroll County, IL",4,6,4,1,1,4,20
"Cook County, IL",4,7,3,1,1,4,20
"Ford County, IL",4,5,4,1,1,5,20
"Grundy County, IL",4,6,4,1,1,4,20
"Iroquois County, IL",4,6,4,1,1,4,20
"LaSalle County, IL",4,6,4,1,1,4,20
"Livingston County, IL",4,6,4,1,1,4,20
"McLean County, IL",4,5,4,1,1,5,20
"Schuyler County, IL",4,4,5,1,1,5,20
"Scott County, IL",4,4,5,1,1,5,20
"Stark County, IL",4,5,4,1,1,5,20
"Warren County, IL",4,5,4,1,1,5,20
"Whiteside County, IL",4,6,4,1,1,4,20
"Will County, IL",4,7,3,1,1,4,20
"Boone County, IL",4,5,4,1,1,4,19
"Bureau County, IL",4,5,4,1,1,4,19
"DeKalb County, IL",4,5,4,1,1,4,19
"Fulton County, IL",4,4,4,1,1,5,19
"Henry County, IL",4,5,4,1,1,4,19
"Knox County, IL",4,5,4,1,1,4,19
"McHenry County, IL",4,5,4,1,1,4,19
"Mercer County, IL",4,4,4,1,1,5,19
"Rock Island County, IL",4,5,4,1,1,4,19
"Kane County, IL",4,5,3,1,1,4,18
"Lake County, IL",4,5,3,1,1,4,18
"McDonough County, IL",4,4,4,1,1,4,18
"Stephenson County, IL",4,5,3,1,1,4,18
"Winnebago County, IL",4,5,3,1,1,4,18
"DuPage County, IL",3,5,3,1,1,4,17
"Ogle County, IL",3,5,3,1,1,4,17
"Jo Daviess County, IL",3,4,3,1,1,4,16
"Lee County, IL",3,4,3,1,1,4,16
"Harrison County, IN",6,9,5,1,1,5,27
"Perry County, IN",6,9,5,1,1,5,27
"Posey County, IN",6,7,6,1,1,5,26
"Spencer County, IN",6,7,6,1,1,5,26
"Vanderburgh County, IN",6,7,6,1,1,5,26
"Warrick County, IN",6,7,6,1,1,5,26
"Floyd County, IN",6,9,4,1,1,5,26
"Gibson County, IN",6,7,5,1,1,5,25
"Knox County, IN",6,7,5,1,1,5,25
"Pike County, IN",6,7,5,1,1,5,25
"Clark County, IN",6,7,4,1,1,5,24
"Ohio County, IN",4,6,4,1,1,6,22
"Crawford County, IN",4,5,5,1,1,6,22
"Daviess County, IN",4,6,5,1,1,5,22
"Dubois County, IN",4,6,5,1,1,5,22
"Fountain County, IN",4,7,4,1,1,5,22
"Jefferson County, IN",6,7,3,1,1,5,23
"Martin County, IN",4,6,5,1,1,5,22
"Sullivan County, IN",4,6,5,1,1,5,22
"Switzerland County, IN",6,7,3,1,1,5,23
"Vigo County, IN",4,7,4,1,1,5,22
"Warren County, IN",4,7,4,1,1,5,22
"Brown County, IN",4,5,3,1,1,6,20
"Greene County, IN",4,5,4,1,1,6,21
"Jasper County, IN",4,7,3,1,1,5,21
"Monroe County, IN",4,7,3,1,1,5,21
"Orange County, IN",4,6,4,1,1,5,21
"Vermillion County, IN",4,6,4,1,1,5,21
"Washington County, IN",4,6,4,1,1,5,21
"Bartholomew County, IN",4,5,4,1,1,5,20
"Benton County, IN",4,6,3,1,1,5,20
"Clay County, IN",4,5,4,1,1,5,20
"Dearborn County, IN",4,6,3,1,1,5,20
"Decatur County, IN",4,6,3,1,1,5,20
"Fayette County, IN",4,6,3,1,1,5,20
"Hendricks County, IN",4,6,3,1,1,5,20
"Jackson County, IN",4,5,4,1,1,5,20
"Lake County, IN",4,6,3,1,1,5,20
"Lawrence County, IN",4,5,4,1,1,5,20
"Montgomery County, IN",4,6,3,1,1,5,20
"Morgan County, IN",4,5,4,1,1,5,20
"Newton County, IN",4,6,3,1,1,5,20
"Owen County, IN",4,5,4,1,1,5,20
"Parke County, IN",4,5,4,1,1,5,20
"Porter County, IN",4,6,3,1,1,5,20
"Ripley County, IN",4,6,3,1,1,5,20
"Tippecanoe County, IN",4,6,3,1,1,5,20
"Adams County, IN",4,5,3,1,1,5,19
"Boone County, IN",4,5,3,1,1,5,19
"Carroll County, IN",4,5,3,1,1,5,19
"Cass County, IN",4,5,3,1,1,5,19
"Clinton County, IN",4,5,3,1,1,5,19
"Franklin County, IN",4,5,3,1,1,5,19
"Grant County, IN",4,5,3,1,1,5,19
"Hamilton County, IN",4,5,3,1,1,5,19
"Hancock County, IN",4,5,3,1,1,5,19
"Howard County, IN",4,5,3,1,1,5,19
"Huntington County, IN",4,5,3,1,1,5,19
"Jennings County, IN",4,5,3,1,1,5,19
"Johnson County, IN",4,5,3,1,1,5,19
"LaPorte County, IN",3,6,3,1,1,5,19
"Madison County, IN",4,5,3,1,1,5,19
"Marion County, IN",4,5,3,1,1,5,19
"Miami County, IN",4,5,3,1,1,5,19
"Putnam County, IN",4,4,4,1,1,5,19
"Rush County, IN",4,5,3,1,1,5,19
"Scott County, IN",4,5,3,1,1,5,19
"Shelby County, IN",4,5,3,1,1,5,19
"Starke County, IN",3,6,3,1,1,5,19
"Tipton County, IN",4,5,3,1,1,5,19
"Union County, IN",4,5,3,1,1,5,19
"Wabash County, IN",4,5,3,1,1,5,19
"Wells County, IN",4,5,3,1,1,5,19
"White County, IN",4,5,3,1,1,5,19
"Allen County, IN",4,4,3,1,1,5,18
"Blackford County, IN",4,4,3,1,1,5,18
"Delaware County, IN",4,4,3,1,1,5,18
"Elkhart County, IN",3,5,3,1,1,5,18
"Fulton County, IN",3,5,3,1,1,5,18
"Jay County, IN",4,4,3,1,1,5,18
"LaGrange County, IN",4,4,3,1,1,5,18
"Marshall County, IN",3,5,3,1,1,5,18
"Pulaski County, IN",3,5,3,1,1,5,18
"St. Joseph County, IN",3,5,3,1,1,5,18
"DeKalb County, IN",3,4,3,1,1,5,17
"Kosciusko County, IN",3,4,3,1,1,5,17
"Noble County, IN",3,4,3,1,1,5,17
"Steuben County, IN",3,4,3,1,1,5,17
"Wayne County, IN",4,2,3,1,1,5,16
"Whitley County, IN",3,4,3,1,1,5,17
"Henry County, IN",3,2,3,1,1,5,15
"Randolph County, IN",3,2,3,1,1,5,15
"Barber County, KS",9,4,9,1,1,5,29
"Clark County, KS",9,2,8,1,2,5,27
"Comanche County, KS",7,4,9,1,1,5,27
"Barton County, KS",7,4,8,1,1,5,26
"Bourbon County, KS",6,4,8,1,2,5,26
"Chautauqua County, KS",7,2,8,1,2,5,25
"Dickinson County, KS",7,4,8,1,1,5,26
"Ellis County, KS",7,2,8,1,2,5,25
"Graham County, KS",7,2,8,1,2,5,25
"Greenwood County, KS",6,2,8,1,3,5,25
"Harper County, KS",7,2,9,1,1,5,25
"Hodgeman County, KS",7,2,8,1,2,5,25
"Kiowa County, KS",7,4,8,1,1,5,26
"Lyon County, KS",6,2,8,1,3,5,25
"Ness County, KS",7,2,8,1,2,5,25
"Osborne County, KS",7,2,8,1,2,5,25
"Ottawa County, KS",7,4,8,1,1,5,26
"Pawnee County, KS",7,4,8,1,1,5,26
"Phillips County, KS",7,2,8,1,2,5,25
"Rooks County, KS",7,2,8,1,2,5,25
"Rush County, KS",7,2,8,1,2,5,25
"Saline County, KS",7,4,8,1,1,5,26
"Sedgwick County, KS",7,4,8,1,1,5,26
"Stafford County, KS",7,4,8,1,1,5,26
"Trego County, KS",7,2,8,1,2,5,25
"Wyandotte County, KS",6,4,8,1,2,5,26
"Anderson County, KS",6,4,8,1,1,5,25
"Chase County, KS",6,2,8,1,2,5,24
"Coffey County, KS",6,2,8,1,2,5,24
"Crawford County, KS",6,4,8,1,1,5,25
"Elk County, KS",6,2,8,1,2,5,24
"Ford County, KS",7,2,8,1,2,5,25
"Geary County, KS",6,2,8,1,2,5,24
"Kingman County, KS",7,2,8,1,1,5,24
"Lincoln County, KS",7,2,8,1,1,5,24
"Linn County, KS",6,2,8,1,2,5,24
"Miami County, KS",6,2,8,1,2,5,24
"Mitchell County, KS",7,2,8,1,1,5,24
"Montgomery County, KS",6,2,8,1,2,5,24
"Morris County, KS",6,2,8,1,2,5,24
"Norton County, KS",7,2,8,1,2,5,25
"Osage County, KS",6,2,8,1,2,6,25
"Pottawatomie County, KS",6,2,8,1,2,5,24
"Pratt County, KS",7,4,8,1,1,5,26
"Reno County, KS",7,2,8,1,1,5,24
"Rice County, KS",7,2,8,1,1,5,24
"Russell County, KS",7,2,8,1,1,5,24
"Smith County, KS",7,2,8,1,1,5,24
"Sumner County, KS",7,2,8,1,1,5,24
"Wabaunsee County, KS",6,2,8,1,2,5,24
"Wilson County, KS",6,2,8,1,2,5,24
"Woodson County, KS",6,2,8,1,2,5,24
"Allen County, KS",6,2,8,1,1,5,23
"Butler County, KS",6,2,8,1,1,5,23
"Cherokee County, KS",6,2,8,1,1,5,23
"Clay County, KS",6,2,8,1,1,5,23
"Cloud County, KS",6,2,8,1,1,5,23
"Cowley County, KS",6,2,8,1,1,5,23
"Douglas County, KS",6,2,8,1,1,5,23
"Edwards County, KS",7,4,7,1,1,5,25
"Ellsworth County, KS",6,2,8,1,1,5,23
"Grant County, KS",7,2,8,1,1,5,24
"Hamilton County, KS",7,2,7,1,2,5,24
"Labette County, KS",6,2,8,1,1,5,23
"McPherson County, KS",6,2,8,1,1,5,23
"Marion County, KS",6,2,8,1,1,5,23
"Meade County, KS",7,2,7,1,2,5,24
"Morton County, KS",7,2,8,1,1,5,24
"Neosho County, KS",6,2,8,1,1,5,23
"Riley County, KS",6,2,8,1,1,5,23
"Scott County, KS",7,2,8,1,1,5,24
"Seward County, KS",7,2,8,1,1,5,24
"Stanton County, KS",7,2,8,1,1,5,24
"Finney County, KS",7,2,7,1,1,5,23
"Franklin County, KS",6,2,8,1,1,5,23
"Gove County, KS",6,2,7,1,2,5,23
"Gray County, KS",7,2,7,1,1,5,23
"Greeley County, KS",7,2,6,1,2,5,23
"Harvey County, KS",6,2,8,1,1,5,23
"Haskell County, KS",7,2,7,1,1,5,23
"Jackson County, KS",6,2,8,1,1,5,23
"Jefferson County, KS",4,2,8,1,1,6,22
"Jewell County, KS",6,2,8,1,1,5,23
"Johnson County, KS",4,2,8,1,2,5,22
"Kearny County, KS",7,2,7,1,1,5,23
"Lane County, KS",7,2,7,1,1,5,23
"Leavenworth County, KS",4,2,8,1,1,5,21
"Logan County, KS",6,2,7,1,2,5,23
"Marshall County, KS",6,2,8,1,1,5,23
"Republic County, KS",6,2,8,1,1,5,23
"Shawnee County, KS",6,2,8,1,1,5,23
"Stevens County, KS",7,2,7,1,1,5,23
"Washington County, KS",6,2,8,1,1,5,23
"Wichita County, KS",7,2,7,1,1,5,23
"Decatur County, KS",6,2,6,1,2,5,22
"Nemaha County, KS",6,2,7,1,1,5,22
"Rawlins County, KS",7,2,5,1,2,5,22
"Thomas County, KS",7,2,5,1,2,5,22
"Wallace County, KS",6,2,6,1,2,5,22
"Atchison County, KS",4,2,7,1,1,5,20
"Brown County, KS",6,2,6,1,1,5,21
"Cheyenne County, KS",7,2,5,1,1,5,21
"Sheridan County, KS",6,2,5,1,2,5,21
"Doniphan County, KS",4,2,6,1,1,5,19
"Sherman County, KS",6,1,5,1,2,5,20
"Ballard County, KY",6,7,8,1,1,5,28
"McCracken County, KY",6,7,8,1,1,5,28
"Carlisle County, KY",6,7,8,1,1,5,28
"Fulton County, KY",6,6,8,1,1,5,27
"Graves County, KY",6,7,8,1,1,5,28
"Livingston County, KY",6,7,8,1,1,5,28
"Marshall County, KY",6,7,8,1,1,5,28
"Christian County, KY",6,7,7,1,1,5,27
"Crittenden County, KY",6,7,7,1,1,5,27
"Hickman County, KY",6,6,8,1,1,5,27
"Lyon County, KY",6,7,7,1,1,5,27
"McLean County, KY",6,7,7,1,1,5,27
"Muhlenberg County, KY",6,7,7,1,1,5,27
"Todd County, KY",6,7,7,1,1,5,27
"Trigg County, KY",6,7,7,1,1,5,27
"Webster County, KY",6,7,7,1,1,5,27
"Butler County, KY",6,7,6,1,1,5,26
"Caldwell County, KY",6,7,6,1,1,5,26
"Calloway County, KY",6,6,7,1,1,5,26
"Daviess County, KY",6,7,6,1,1,5,26
"Hancock County, KY",6,9,5,1,1,5,27
"Henderson County, KY",6,7,6,1,1,5,26
"Ohio County, KY",6,6,7,1,1,5,26
"Union County, KY",6,7,6,1,1,5,26
"Warren County, KY",6,7,6,1,1,5,26
"Barren County, KY",7,7,4,1,1,5,25
"Bullitt County, KY",6,9,4,1,1,5,26
"Edmonson County, KY",7,7,4,1,1,5,25
"Elliott County, KY",6,6,5,1,2,5,25
"Hopkins County, KY",6,5,7,1,1,5,25
"Jefferson County, KY",6,9,4,1,1,5,26
"Logan County, KY",6,6,6,1,1,5,25
"Simpson County, KY",6,6,5,1,1,5,24
"Spencer County, KY",6,9,3,1,1,5,25
"Adair County, KY",6,6,4,1,1,5,23
"Breckinridge County, KY",6,6,4,1,1,5,23
"Carroll County, KY",6,7,3,1,1,5,23
"Green County, KY",6,6,4,1,1,5,23
"Meade County, KY",6,6,4,1,1,5,23
"Menifee County, KY",6,6,3,1,2,5,23
"Metcalfe County, KY",6,6,4,1,1,5,23
"Monroe County, KY",6,6,4,1,1,5,23
"Montgomery County, KY",6,5,4,1,2,5,23
"Powell County, KY",6,6,3,1,2,5,23
"Rowan County, KY",6,6,3,1,2,5,23
"Shelby County, KY",6,7,3,1,1,5,23
"Taylor County, KY",6,6,4,1,1,5,23
"Bath County, KY",6,5,3,1,2,5,22
"Henry County, KY",6,6,3,1,1,5,22
"Kenton County, KY",4,5,5,1,1,5,21
"Marion County, KY",6,5,4,1,1,5,22
"Nelson County, KY",4,5,5,1,1,5,21
"Oldham County, KY",6,6,3,1,1,5,22
"Trimble County, KY",6,6,3,1,1,5,22
"Washington County, KY",6,5,4,1,1,5,22
"Allen County, KY",4,4,5,1,1,5,20
"Anderson County, KY",4,5,4,1,1,5,20
"Boyle County, KY",6,5,3,1,1,5,21
"Campbell County, KY",4,5,4,1,1,5,20
"Casey County, KY",6,5,3,1,1,5,21
"Clay County, KY",4,4,4,1,2,5,20
"Fleming County, KY",6,5,3,1,1,5,21
"Franklin County, KY",4,5,4,1,1,5,20
"Gallatin County, KY",4,6,3,1,1,5,20
"Hardin County, KY",4,5,4,1,1,5,20
"Hart County, KY",4,5,4,1,1,5,20
"Jackson County, KY",4,4,4,1,2,5,20
"Larue County, KY",4,5,4,1,1,5,20
"Laurel County, KY",4,4,4,1,2,5,20
"Lewis County, KY",6,5,3,1,1,5,21
"Madison County, KY",4,4,4,1,2,5,20
"Mercer County, KY",4,5,4,1,1,5,20
"Pulaski County, KY",4,5,3,1,2,5,20
"Rockcastle County, KY",4,4,4,1,2,5,20
"Whitley County, KY",4,2,5,1,2,5,19
"Boone County, KY",4,5,3,1,1,5,19
"Carter County, KY",3,4,4,1,2,5,19
"Clark County, KY",4,5,3,1,1,5,19
"Cumberland County, KY",4,4,4,1,1,5,19
"Estill County, KY",4,4,3,1,2,5,19
"Fayette County, KY",4,5,3,1,1,5,19
"Floyd County, KY",3,4,4,1,2,5,19
"Garrard County, KY",4,4,4,1,1,5,19
"Grant County, KY",4,5,3,1,1,5,19
"Grayson County, KY",4,4,4,1,1,5,19
"Greenup County, KY",4,4,3,1,2,5,19
"Harrison County, KY",4,4,4,1,1,5,19
"Jessamine County, KY",4,5,3,1,1,5,19
"Johnson County, KY",3,4,4,1,2,5,19
"Knox County, KY",4,4,3,1,2,5,19
"Lawrence County, KY",4,4,3,1,2,5,19
"Nicholas County, KY",4,4,4,1,1,5,19
"Owen County, KY",4,5,3,1,1,5,19
"Owsley County, KY",3,4,4,1,2,5,19
"Pendleton County, KY",4,5,3,1,1,5,19
"Robertson County, KY",4,4,4,1,1,5,19
"Russell County, KY",4,4,3,1,2,5,19
"Scott County, KY",4,5,3,1,1,5,19
"Wayne County, KY",4,4,3,1,2,5,19
"Wolfe County, KY",3,4,4,1,2,5,19
"Woodford County, KY",4,5,3,1,1,5,19
"Bourbon County, KY",4,4,3,1,1,5,18
"Bracken County, KY",4,4,3,1,1,5,18
"Breathitt County, KY",3,2,4,1,2,5,17
"Clinton County, KY",4,4,3,1,1,5,18
"Lee County, KY",3,4,3,1,2,5,18
"Lincoln County, KY",4,4,3,1,1,5,18
"McCreary County, KY",4,2,3,1,2,5,17
"Magoffin County, KY",3,2,4,1,2,5,17
"Mason County, KY",4,5,3,1,1,4,18
"Morgan County, KY",3,4,3,1,2,5,18
"Perry County, KY",3,2,4,1,2,5,17
"Bell County, KY",4,2,3,1,2,4,16
"Boyd County, KY",3,4,3,1,2,4,17
"Leslie County, KY",4,4,1,1,2,5,17
"Pike County, KY",3,1,3,1,2,5,15
"Martin County, KY",4,4,1,1,2,4,16
"Harlan County, KY",4,1,1,1,2,5,14
"Knott County, KY",3,2,1,1,2,5,14
"Letcher County, KY",3,1,1,1,2,4,12
"St. Martin Parish, LA",7,10,8,4,3,7,39
"Assumption Parish, LA",6,9,7,7,2,9,40
"Jefferson Davis Parish, LA",7,10,8,4,1,8,38
"Livingston Parish, LA",7,9,8,6,1,8,39
"St. John the Baptist Parish, LA",6,9,8,6,2,8,39
"Calcasieu Parish, LA",6,10,8,4,1,8,37
"Lafayette Parish, LA",7,10,8,3,2,7,37
"St. James Parish, LA",6,10,8,6,2,6,38
"St. Landry Parish, LA",7,9,8,3,3,7,37
"Beauregard Parish, LA",7,10,9,1,1,7,35
"Lafourche Parish, LA",4,9,8,6,2,7,36
"East Baton Rouge Parish, LA",7,10,9,3,2,5,36
"Iberville Parish, LA",7,9,8,4,2,6,36
"Pointe Coupee Parish, LA",7,10,8,1,3,6,35
"Tangipahoa Parish, LA",7,7,8,4,1,7,34
"Acadia Parish, LA",6,7,8,4,1,7,33
"Ascension Parish, LA",6,9,8,4,2,6,35
"Cameron Parish, LA",6,10,3,10,1,8,38
"Evangeline Parish, LA",7,7,8,1,1,7,31
"West Baton Rouge Parish, LA",7,10,8,1,2,5,33
"Allen Parish, LA",7,6,8,1,1,7,30
"St. Mary Parish, LA",4,9,3,7,2,8,33
"Vermilion Parish, LA",6,9,3,6,1,9,34
"Iberia Parish, LA",6,9,3,4,2,8,32
"Vernon Parish, LA",7,4,10,1,1,6,29
"Avoyelles Parish, LA",7,4,8,1,3,6,29
"East Feliciana Parish, LA",6,5,8,1,1,7,28
"Rapides Parish, LA",7,7,8,1,1,5,29
"Terrebonne Parish, LA",4,9,1,7,3,8,32
"Bossier Parish, LA",9,4,9,1,1,5,29
"De Soto Parish, LA",9,4,9,1,1,5,29
"Ouachita Parish, LA",9,5,8,1,1,5,29
"Washington Parish, LA",7,6,8,1,1,6,29
"Bienville Parish, LA",7,2,10,1,1,5,26
"Caddo Parish, LA",9,4,8,1,1,5,28
"Caldwell Parish, LA",9,2,9,1,1,5,27
"Natchitoches Parish, LA",9,4,8,1,1,5,28
"Union Parish, LA",7,4,9,1,1,5,27
"West Feliciana Parish, LA",7,2,9,1,1,6,26
"Catahoula Parish, LA",9,2,8,1,1,6,27
"Claiborne Parish, LA",7,2,9,1,1,5,25
"Grant Parish, LA",7,2,9,1,1,5,25
"Lincoln Parish, LA",7,2,9,1,1,5,25
"Richland Parish, LA",9,4,8,1,1,5,28
"St. Bernard Parish, LA",4,6,1,7,2,8,28
"St. Charles Parish, LA",6,10,1,7,2,5,31
"Franklin Parish, LA",9,2,8,1,1,5,26
"Jefferson Parish, LA",6,7,1,4,2,7,27
"LaSalle Parish, LA",7,2,8,1,1,5,24
"Red River Parish, LA",7,2,8,1,1,5,24
"Tensas Parish, LA",9,2,7,1,1,6,26
"East Carroll Parish, LA",7,5,6,1,1,5,25
"Madison Parish, LA",7,4,7,1,1,5,25
"Orleans Parish, LA",6,7,1,4,2,6,26
"West Carroll Parish, LA",7,4,7,1,1,5,25
"Concordia Parish, LA",7,2,7,1,1,5,23
"Morehouse Parish, LA",7,2,7,1,1,5,23
"St. Helena Parish, LA",7,6,1,1,1,8,24
"St. Tammany Parish, LA",6,5,1,4,2,7,25
"Plaquemines Parish, LA",6,7,1,6,1,5,26
"Sabine Parish, LA",9,4,1,1,1,5,21
"Winn Parish, LA",9,4,1,1,1,5,21
"Webster Parish, LA",7,4,1,1,1,5,19
"Jackson Parish, LA",7,2,1,1,1,5,17
"Suffolk County, MA",3,4,1,6,1,5,20
"Barnstable County, MA",3,2,1,7,1,4,18
"Dukes County, MA",3,4,1,4,1,5,18
"Essex County, MA",3,5,1,4,1,4,18
"Nantucket County, MA",3,2,1,4,1,6,17
"Hampden County, MA",4,5,1,1,1,4,16
"Middlesex County, MA",3,4,1,4,1,4,17
"Norfolk County, MA",3,4,1,4,1,4,17
"Bristol County, MA",3,2,1,4,1,4,15
"Plymouth County, MA",3,2,1,4,1,4,15
"Franklin County, MA",3,4,1,1,1,4,14
"Hampshire County, MA",3,4,1,1,1,4,14
"Worcester County, MA",3,4,1,1,1,4,14
"Berkshire County, MA",3,2,1,1,1,4,12
"Worcester County, MD",4,5,4,6,2,6,27
"Somerset County, MD",4,5,4,7,1,6,27
"Dorchester County, MD",4,5,4,7,1,5,26
"Talbot County, MD",4,5,4,4,1,5,23
"Caroline County, MD",4,4,5,4,1,4,22
"Kent County, MD",4,4,5,4,1,4,22
"Queen Anne's County, MD",4,4,5,4,1,4,22
"Anne Arundel County, MD",4,4,5,3,1,4,21
"Charles County, MD",4,4,4,4,1,4,21
"Prince George's County, MD",6,2,5,3,1,4,21
"Wicomico County, MD",4,4,4,4,1,4,21
"Montgomery County, MD",4,4,5,1,1,4,19
"St. Mary's County, MD",4,4,3,4,1,4,20
"Allegany County, MD",6,2,3,1,2,4,18
"Calvert County, MD",4,1,4,4,1,4,18
"Cecil County, MD",4,1,4,4,1,4,18
"Baltimore County, MD",4,1,4,3,1,4,17
"Harford County, MD",4,1,4,3,1,4,17
"Washington County, MD",4,2,3,1,2,4,16
"Frederick County, MD",3,2,4,1,1,4,15
"Garrett County, MD",3,2,3,1,2,4,15
"Howard County, MD",4,1,4,1,1,4,15
"Carroll County, MD",3,1,3,1,1,4,13
"Baltimore city, MD",4,1,1,3,1,4,14
"Hancock County, ME",3,4,1,3,1,6,18
"Cumberland County, ME",3,4,1,4,1,4,17
"Sagadahoc County, ME",3,5,1,4,1,3,17
"York County, ME",3,4,1,4,1,4,17
"Knox County, ME",3,4,1,3,1,4,16
"Androscoggin County, ME",3,4,1,1,1,4,14
"Kennebec County, ME",3,4,1,1,1,4,14
"Penobscot County, ME",3,4,1,3,1,3,15
"Washington County, ME",3,4,1,4,1,2,15
"Lincoln County, ME",3,2,1,4,1,2,13
"Waldo County, ME",3,2,1,3,1,3,13
"Oxford County, ME",3,4,1,1,1,2,12
"Somerset County, ME",3,2,1,1,1,3,11
"Aroostook County, ME",3,2,1,1,1,2,10
"Franklin County, ME",3,2,1,1,1,2,10
"Piscataquis County, ME",3,2,1,1,1,1,9
"Berrien County, MI",4,5,3,1,1,4,18
"Mackinac County, MI",3,4,3,1,3,4,18
"St. Joseph County, MI",4,5,3,1,1,4,18
"Baraga County, MI",3,2,3,1,3,4,16
"Bay County, MI",3,5,3,1,1,4,17
"Cheboygan County, MI",3,4,3,1,2,4,17
"Gogebic County, MI",3,4,3,1,2,4,17
"Hillsdale County, MI",4,4,3,1,1,4,17
"Monroe County, MI",3,5,3,1,1,4,17
"Oakland County, MI",4,4,3,1,1,4,17
"Oscoda County, MI",3,4,3,1,2,4,17
"Otsego County, MI",3,4,3,1,2,4,17
"Ottawa County, MI",3,5,3,1,1,4,17
"Van Buren County, MI",3,5,3,1,1,4,17
"Wayne County, MI",4,4,3,1,1,4,17
"Alcona County, MI",3,4,3,1,1,4,16
"Alpena County, MI",3,4,3,1,1,4,16
"Barry County, MI",3,4,3,1,1,4,16
"Branch County, MI",3,4,3,1,1,4,16
"Calhoun County, MI",3,4,3,1,1,4,16
"Cass County, MI",3,4,3,1,1,4,16
"Chippewa County, MI",3,4,3,1,1,4,16
"Clinton County, MI",3,4,3,1,1,4,16
"Eaton County, MI",3,4,3,1,1,4,16
"Emmet County, MI",3,2,3,1,2,4,15
"Genesee County, MI",3,4,3,1,1,4,16
"Gladwin County, MI",3,4,3,1,1,4,16
"Gratiot County, MI",3,4,3,1,1,4,16
"Houghton County, MI",3,2,3,1,3,3,15
"Huron County, MI",3,4,3,1,1,4,16
"Ingham County, MI",3,4,3,1,1,4,16
"Jackson County, MI",3,4,3,1,1,4,16
"Kalamazoo County, MI",3,4,3,1,1,4,16
"Kalkaska County, MI",3,2,3,1,2,4,15
"Lapeer County, MI",3,4,3,1,1,4,16
"Lenawee County, MI",3,4,3,1,1,4,16
"Livingston County, MI",3,4,3,1,1,4,16
"Marquette County, MI",3,1,3,1,3,4,15
"Midland County, MI",3,4,3,1,1,4,16
"Missaukee County, MI",3,2,3,1,2,4,15
"Montmorency County, MI",3,2,3,1,2,4,15
"Ogemaw County, MI",3,2,3,1,2,4,15
"Ontonagon County, MI",3,5,3,1,1,3,16
"Roscommon County, MI",3,2,3,1,2,4,15
"Saginaw County, MI",3,4,3,1,1,4,16
"Sanilac County, MI",3,4,3,1,1,4,16
"Shiawassee County, MI",3,4,3,1,1,4,16
"Tuscola County, MI",3,4,3,1,1,4,16
"Washtenaw County, MI",3,4,3,1,1,4,16
"Allegan County, MI",3,2,3,1,1,4,14
"Clare County, MI",3,2,3,1,1,4,14
"Dickinson County, MI",3,1,3,1,2,4,14
"Ionia County, MI",3,2,3,1,1,4,14
"Iosco County, MI",3,2,3,1,1,4,14
"Isabella County, MI",3,2,3,1,1,4,14
"Kent County, MI",3,2,3,1,1,4,14
"Macomb County, MI",3,2,3,1,1,4,14
"Mason County, MI",3,2,3,1,1,4,14
"Menominee County, MI",3,1,3,1,2,4,14
"Montcalm County, MI",3,2,3,1,1,4,14
"Muskegon County, MI",3,2,3,1,1,4,14
"Newaygo County, MI",3,2,3,1,1,4,14
"Presque Isle County, MI",3,2,3,1,1,4,14
"St. Clair County, MI",3,2,3,1,1,4,14
"Schoolcraft County, MI",3,1,3,1,2,4,14
"Wexford County, MI",3,1,3,1,2,4,14
"Antrim County, MI",3,1,3,1,1,4,13
"Arenac County, MI",3,1,3,1,1,4,13
"Benzie County, MI",3,1,3,1,1,4,13
"Charlevoix County, MI",3,1,3,1,1,4,13
"Delta County, MI",3,1,3,1,1,4,13
"Grand Traverse County, MI",3,1,3,1,1,4,13
"Iron County, MI",3,2,1,1,3,4,14
"Lake County, MI",3,1,3,1,1,4,13
"Leelanau County, MI",3,1,3,1,1,4,13
"Manistee County, MI",3,1,3,1,1,4,13
"Mecosta County, MI",3,1,3,1,1,4,13
"Oceana County, MI",3,1,3,1,1,4,13
"Osceola County, MI",3,1,3,1,1,4,13
"Alger County, MI",3,1,3,1,1,3,12
"Crawford County, MI",3,2,1,1,2,4,13
"Luce County, MI",3,2,1,1,1,4,12
"Keweenaw County, MI",3,5,1,1,1,1,12
"St. Louis County, MN",3,1,3,1,7,4,19
"Aitkin County, MN",3,2,3,1,6,4,19
"Beltrami County, MN",3,1,3,1,6,4,18
"Cass County, MN",3,2,3,1,6,4,19
"Itasca County, MN",3,1,3,1,6,4,18
"Koochiching County, MN",3,1,3,1,6,4,18
"Clearwater County, MN",3,1,3,1,6,4,18
"Crow Wing County, MN",3,2,3,1,5,4,18
"Morrison County, MN",4,4,3,1,3,4,19
"Blue Earth County, MN",4,5,3,1,1,4,18
"Carlton County, MN",3,4,3,1,3,4,18
"Faribault County, MN",4,5,3,1,1,4,18
"Le Sueur County, MN",4,5,3,1,1,4,18
"McLeod County, MN",4,5,3,1,1,4,18
"Martin County, MN",4,5,3,1,1,4,18
"Pine County, MN",3,4,3,1,3,4,18
"Brown County, MN",3,5,3,1,1,4,17
"Cottonwood County, MN",4,4,3,1,1,4,17
"Freeborn County, MN",3,5,3,1,1,4,17
"Hubbard County, MN",3,1,3,1,4,4,16
"Mille Lacs County, MN",3,2,3,1,3,4,16
"Nicollet County, MN",3,5,3,1,1,4,17
"Ramsey County, MN",3,5,3,1,1,4,17
"Renville County, MN",4,4,3,1,1,4,17
"Sibley County, MN",3,5,3,1,1,4,17
"Waseca County, MN",4,4,3,1,1,4,17
"Carver County, MN",3,4,3,1,1,4,16
"Dakota County, MN",3,4,3,1,1,4,16
"Dodge County, MN",3,4,3,1,1,4,16
"Fillmore County, MN",3,4,3,1,1,4,16
"Goodhue County, MN",3,4,3,1,1,4,16
"Hennepin County, MN",3,4,3,1,1,4,16
"Jackson County, MN",4,2,3,1,1,4,15
"Kandiyohi County, MN",3,4,3,1,1,4,16
"Lake County, MN",3,1,1,1,6,4,16
"Lincoln County, MN",4,2,3,1,1,4,15
"Lyon County, MN",4,2,3,1,1,4,15
"Meeker County, MN",3,4,3,1,1,4,16
"Mower County, MN",3,4,3,1,1,4,16
"Norman County, MN",4,2,3,1,1,4,15
"Olmsted County, MN",3,4,3,1,1,4,16
"Redwood County, MN",4,2,3,1,1,4,15
"Rice County, MN",3,4,3,1,1,4,16
"Scott County, MN",3,4,3,1,1,4,16
"Stearns County, MN",3,4,3,1,1,4,16
"Steele County, MN",3,4,3,1,1,4,16
"Wabasha County, MN",3,4,3,1,1,4,16
"Washington County, MN",3,4,3,1,1,4,16
"Watonwan County, MN",3,4,3,1,1,4,16
"Winona County, MN",3,4,3,1,1,4,16
"Wright County, MN",3,4,3,1,1,4,16
"Yellow Medicine County, MN",4,2,3,1,1,4,15
"Chippewa County, MN",4,1,3,1,1,4,14
"Chisago County, MN",3,2,3,1,1,4,14
"Clay County, MN",4,1,3,1,1,4,14
"Isanti County, MN",3,2,3,1,1,4,14
"Kanabec County, MN",3,1,3,1,2,4,14
"Lac qui Parle County, MN",4,1,3,1,1,4,14
"Otter Tail County, MN",3,2,3,1,1,4,14
"Pipestone County, MN",4,1,3,1,1,4,14
"Pope County, MN",4,1,3,1,1,4,14
"Rock County, MN",4,1,3,1,1,4,14
"Sherburne County, MN",3,2,3,1,1,4,14
"Swift County, MN",4,1,3,1,1,4,14
"Todd County, MN",3,2,3,1,1,4,14
"Wadena County, MN",3,2,3,1,1,4,14
"Anoka County, MN",3,1,3,1,1,4,13
"Becker County, MN",3,1,3,1,1,4,13
"Benton County, MN",3,1,3,1,1,4,13
"Big Stone County, MN",3,1,3,1,1,4,13
"Cook County, MN",3,1,1,1,6,2,14
"Douglas County, MN",3,1,3,1,1,4,13
"Grant County, MN",3,1,3,1,1,4,13
"Houston County, MN",3,1,3,1,1,4,13
"Kittson County, MN",3,1,3,1,1,4,13
"Lake of the Woods County, MN",3,1,3,1,1,4,13
"Mahnomen County, MN",3,1,3,1,1,4,13
"Marshall County, MN",3,1,3,1,1,4,13
"Murray County, MN",3,1,3,1,1,4,13
"Nobles County, MN",3,1,3,1,1,4,13
"Pennington County, MN",3,1,3,1,1,4,13
"Polk County, MN",3,1,3,1,1,4,13
"Red Lake County, MN",3,1,3,1,1,4,13
"Roseau County, MN",3,1,3,1,1,4,13
"Stevens County, MN",3,1,3,1,1,4,13
"Traverse County, MN",3,1,3,1,1,4,13
"Wilkin County, MN",3,1,3,1,1,4,13
"Camden County, MO",6,6,8,1,2,6,29
"Hickory County, MO",6,5,8,1,2,7,29
"Wayne County, MO",6,7,8,1,2,6,30
"Bollinger County, MO",6,6,8,1,2,6,29
"Dunklin County, MO",6,7,8,1,1,5,28
"Maries County, MO",6,7,7,1,2,6,29
"Phelps County, MO",6,7,8,1,2,5,29
"Ripley County, MO",6,5,8,1,2,6,28
"Cape Girardeau County, MO",6,7,8,1,1,5,28
"Carter County, MO",6,9,6,1,2,5,29
"Cedar County, MO",6,5,8,1,2,5,27
"Morgan County, MO",4,5,8,1,2,6,26
"New Madrid County, MO",6,7,8,1,1,5,28
"Osage County, MO",6,7,8,1,1,5,28
"Pemiscot County, MO",6,7,8,1,1,5,28
"Scott County, MO",6,7,8,1,1,5,28
"Stone County, MO",6,2,8,1,2,6,25
"Bates County, MO",6,4,8,1,3,5,27
"Butler County, MO",6,5,8,1,2,5,27
"Christian County, MO",6,2,8,1,2,6,25
"Cole County, MO",6,7,7,1,1,5,27
"Dallas County, MO",4,5,8,1,2,6,26
"Franklin County, MO",6,7,7,1,1,5,27
"Gasconade County, MO",6,7,7,1,1,5,27
"Laclede County, MO",4,5,8,1,2,5,25
"Miller County, MO",6,6,7,1,2,5,27
"Mississippi County, MO",6,6,8,1,1,5,27
"Perry County, MO",6,6,8,1,1,5,27
"St. Clair County, MO",6,2,8,1,2,6,25
"Ste. Genevieve County, MO",6,6,8,1,1,5,27
"Vernon County, MO",6,4,8,1,2,5,26
"Barton County, MO",6,4,8,1,2,5,26
"Benton County, MO",4,2,8,1,2,6,23
"Carroll County, MO",6,6,7,1,1,5,26
"Chariton County, MO",6,6,6,1,2,5,26
"Clay County, MO",6,4,8,1,2,5,26
"Crawford County, MO",6,7,5,1,2,5,26
"Dade County, MO",6,2,8,1,2,5,24
"Dent County, MO",6,5,7,1,2,5,26
"Henry County, MO",6,4,8,1,2,5,26
"Jasper County, MO",6,2,8,1,2,5,24
"Jefferson County, MO",6,5,6,1,2,6,26
"Johnson County, MO",6,4,8,1,2,5,26
"Lafayette County, MO",6,5,7,1,1,6,26
"Lawrence County, MO",6,2,8,1,2,5,24
"Platte County, MO",6,4,8,1,2,5,26
"Polk County, MO",6,2,8,1,2,5,24
"Pulaski County, MO",4,5,8,1,2,5,25
"Ray County, MO",6,4,7,1,2,6,26
"Reynolds County, MO",6,7,5,1,2,5,26
"St. Francois County, MO",6,5,7,1,2,5,26
"Saline County, MO",6,5,7,1,2,5,26
"Stoddard County, MO",6,5,8,1,1,5,26
"Taney County, MO",6,2,8,1,2,5,24
"Texas County, MO",4,5,8,1,2,5,25
"Warren County, MO",6,6,7,1,1,5,26
"Washington County, MO",6,7,5,1,2,5,26
"Barry County, MO",4,2,8,1,2,5,22
"Boone County, MO",6,4,7,1,2,5,25
"Cass County, MO",4,2,8,1,2,6,23
"Cooper County, MO",4,5,7,1,2,5,24
"Greene County, MO",6,2,8,1,2,5,24
"Howard County, MO",4,5,7,1,2,5,24
"Howell County, MO",6,1,8,1,2,5,23
"Jackson County, MO",4,4,8,1,2,5,24
"McDonald County, MO",4,2,8,1,2,5,22
"Madison County, MO",6,6,5,1,2,5,25
"Moniteau County, MO",4,6,7,1,1,5,24
"Newton County, MO",4,2,8,1,2,5,22
"Pettis County, MO",4,5,7,1,2,5,24
"St. Louis County, MO",6,5,7,1,1,5,25
"Webster County, MO",4,2,8,1,2,5,22
"Wright County, MO",4,4,8,1,2,5,24
"Atchison County, MO",6,5,6,1,1,5,24
"Douglas County, MO",4,2,8,1,2,5,22
"Lincoln County, MO",6,4,6,1,1,6,24
"Livingston County, MO",6,4,6,1,2,5,24
"Marion County, MO",4,5,6,1,2,5,23
"Monroe County, MO",4,5,6,1,2,5,23
"Ozark County, MO",4,2,7,1,2,6,22
"Ralls County, MO",4,5,6,1,2,5,23
"Randolph County, MO",4,5,6,1,2,5,23
"Andrew County, MO",4,4,7,1,1,5,22
"Audrain County, MO",4,4,6,1,2,5,22
"Buchanan County, MO",4,4,7,1,1,5,22
"Callaway County, MO",4,5,6,1,1,5,22
"Clark County, MO",4,5,5,1,2,5,22
"Lewis County, MO",4,5,5,1,2,5,22
"Linn County, MO",4,5,5,1,2,5,22
"Montgomery County, MO",4,5,6,1,1,5,22
"Nodaway County, MO",4,5,6,1,1,5,22
"Pike County, MO",6,4,6,1,1,5,23
"St. Charles County, MO",4,4,7,1,1,5,22
"Scotland County, MO",6,4,5,1,2,5,23
"Caldwell County, MO",4,4,6,1,1,5,21
"DeKalb County, MO",4,4,6,1,1,5,21
"Gentry County, MO",4,4,6,1,1,5,21
"Grundy County, MO",4,4,5,1,2,5,21
"Holt County, MO",4,4,6,1,1,5,21
"Iron County, MO",6,4,4,1,2,5,22
"Knox County, MO",4,4,5,1,2,5,21
"Macon County, MO",4,4,5,1,2,5,21
"Shelby County, MO",4,4,5,1,2,5,21
"Sullivan County, MO",4,4,5,1,2,5,21
"Adair County, MO",4,4,4,1,2,5,20
"Clinton County, MO",4,2,6,1,1,5,19
"Daviess County, MO",4,4,5,1,1,5,20
"Harrison County, MO",4,4,5,1,1,5,20
"Mercer County, MO",4,4,4,1,2,5,20
"Putnam County, MO",4,4,4,1,2,5,20
"Schuyler County, MO",4,4,4,1,2,5,20
"Shannon County, MO",6,7,1,1,2,5,22
"Worth County, MO",4,4,5,1,1,5,20
"Oregon County, MO",6,4,1,1,2,5,19
"St. Louis city, MO",6,5,1,1,1,5,19
"Jackson County, MS",6,9,8,4,3,8,38
"Harrison County, MS",7,7,8,4,2,7,35
"Clarke County, MS",7,6,9,1,1,7,31
"Stone County, MS",7,6,8,1,1,8,31
"Carroll County, MS",7,7,8,1,1,6,30
"Jefferson Davis County, MS",6,5,9,1,1,8,30
"Lamar County, MS",6,7,8,1,1,7,30
"Perry County, MS",6,6,9,1,1,7,30
"Simpson County, MS",7,6,8,1,1,7,30
"Walthall County, MS",7,5,8,1,1,8,30
"Warren County, MS",7,9,9,1,1,5,32
"Amite County, MS",7,4,8,1,1,8,29
"Copiah County, MS",7,4,9,1,1,7,29
"George County, MS",6,5,8,1,1,8,29
"Greene County, MS",6,5,8,1,1,8,29
"Lawrence County, MS",7,5,8,1,1,7,29
"Lincoln County, MS",7,5,8,1,1,7,29
"Neshoba County, MS",7,7,9,1,1,5,30
"Smith County, MS",7,5,8,1,1,7,29
"Tate County, MS",7,9,8,1,1,5,31
"Wilkinson County, MS",7,2,9,1,1,8,28
"Claiborne County, MS",7,6,9,1,1,5,29
"Clay County, MS",7,7,8,1,1,5,29
"Covington County, MS",6,5,8,1,1,7,28
"Forrest County, MS",6,6,9,1,1,6,29
"Franklin County, MS",7,4,8,1,1,7,28
"Jasper County, MS",7,5,9,1,1,6,29
"Jefferson County, MS",7,4,8,1,1,7,28
"Lafayette County, MS",7,7,8,1,1,5,29
"Lee County, MS",7,7,8,1,1,5,29
"Lowndes County, MS",7,7,8,1,1,5,29
"Marion County, MS",6,5,8,1,1,7,28
"Monroe County, MS",7,7,8,1,1,5,29
"Pike County, MS",7,4,8,1,1,7,28
"Wayne County, MS",7,5,8,1,1,6,28
"Winston County, MS",7,7,8,1,1,5,29
"Hinds County, MS",7,5,9,1,1,5,28
"Holmes County, MS",7,6,8,1,1,5,28
"Humphreys County, MS",7,7,8,1,1,5,29
"Jones County, MS",7,5,8,1,1,6,28
"Leake County, MS",7,6,8,1,1,5,28
"Madison County, MS",7,6,8,1,1,5,28
"Marshall County, MS",7,6,8,1,1,5,28
"Noxubee County, MS",7,6,8,1,1,5,28
"Oktibbeha County, MS",7,6,8,1,1,5,28
"Rankin County, MS",7,6,8,1,1,5,28
"Sharkey County, MS",9,9,6,1,1,5,31
"Yalobusha County, MS",7,6,8,1,1,5,28
"Yazoo County, MS",7,7,8,1,1,5,29
"Adams County, MS",7,2,8,1,1,6,25
"Calhoun County, MS",6,6,8,1,1,5,27
"Grenada County, MS",6,6,8,1,1,5,27
"Issaquena County, MS",9,5,8,1,1,5,29
"Kemper County, MS",7,5,8,1,1,5,27
"Lauderdale County, MS",7,4,9,1,1,5,27
"Newton County, MS",7,4,8,1,1,6,27
"Panola County, MS",7,5,8,1,1,5,27
"Pearl River County, MS",4,5,8,1,1,7,26
"Pontotoc County, MS",6,6,8,1,1,5,27
"Scott County, MS",7,5,8,1,1,5,27
"Sunflower County, MS",7,7,7,1,1,5,28
"Attala County, MS",6,5,8,1,1,5,26
"Benton County, MS",6,5,8,1,1,5,26
"Chickasaw County, MS",6,5,8,1,1,5,26
"DeSoto County, MS",7,4,8,1,1,5,26
"Hancock County, MS",4,6,1,6,2,9,28
"Itawamba County, MS",6,5,8,1,1,5,26
"Leflore County, MS",7,6,7,1,1,5,27
"Prentiss County, MS",6,6,8,1,1,5,27
"Tippah County, MS",6,5,8,1,1,5,26
"Union County, MS",6,5,8,1,1,5,26
"Webster County, MS",6,5,8,1,1,5,26
"Alcorn County, MS",6,5,8,1,1,5,26
"Bolivar County, MS",7,5,7,1,1,5,26
"Choctaw County, MS",6,4,8,1,1,5,25
"Coahoma County, MS",7,4,8,1,1,5,26
"Montgomery County, MS",6,4,8,1,1,5,25
"Quitman County, MS",7,4,8,1,1,5,26
"Tunica County, MS",7,4,8,1,1,5,26
"Washington County, MS",7,6,6,1,1,5,26
"Tallahatchie County, MS",6,4,8,1,1,5,25
"Tishomingo County, MS",6,4,8,1,1,5,25
"Big Horn County, MT",6,1,4,1,7,4,23
"Rosebud County, MT",6,1,4,1,7,4,23
"Carter County, MT",4,2,4,1,6,4,21
"Custer County, MT",6,1,4,1,6,4,22
"Dawson County, MT",6,2,4,1,6,4,23
"Garfield County, MT",4,1,4,1,7,4,21
"Sanders County, MT",6,1,3,1,7,4,22
"Blaine County, MT",4,1,4,1,6,4,20
"Fergus County, MT",3,1,4,1,7,4,20
"Flathead County, MT",4,1,3,1,7,4,20
"Musselshell County, MT",6,1,4,1,6,4,22
"Petroleum County, MT",6,1,4,1,6,4,22
"Phillips County, MT",4,1,4,1,6,4,20
"Prairie County, MT",6,1,4,1,6,4,22
"Valley County, MT",4,1,4,1,6,4,20
"Yellowstone County, MT",4,1,4,1,6,4,20
"Chouteau County, MT",4,1,3,1,6,4,19
"Hill County, MT",4,1,4,1,6,4,20
"Lewis and Clark County, MT",4,1,3,1,6,4,19
"McCone County, MT",4,1,4,1,6,4,20
"Treasure County, MT",4,1,4,1,6,4,20
"Carbon County, MT",4,1,3,1,6,4,19
"Fallon County, MT",4,1,4,1,5,4,19
"Lake County, MT",3,1,3,1,6,4,18
"Ravalli County, MT",3,1,3,1,6,4,18
"Richland County, MT",6,1,4,1,4,4,20
"Stillwater County, MT",4,1,3,1,6,4,19
"Sweet Grass County, MT",4,1,3,1,6,4,19
"Golden Valley County, MT",4,1,3,1,5,4,18
"Lincoln County, MT",6,1,1,1,6,4,19
"Powder River County, MT",6,1,1,1,6,4,19
"Roosevelt County, MT",4,1,4,1,4,4,18
"Beaverhead County, MT",3,1,1,1,7,4,17
"Cascade County, MT",4,1,1,1,6,4,17
"Daniels County, MT",4,1,4,1,3,4,17
"Gallatin County, MT",4,1,1,1,6,4,17
"Missoula County, MT",4,1,1,1,6,4,17
"Sheridan County, MT",4,1,4,1,3,4,17
"Toole County, MT",3,1,3,1,5,4,17
"Wheatland County, MT",3,1,3,1,5,4,17
"Wibaux County, MT",4,1,4,1,3,4,17
"Broadwater County, MT",4,1,1,1,6,4,17
"Madison County, MT",3,1,1,1,6,4,16
"Meagher County, MT",3,1,1,1,6,4,16
"Mineral County, MT",4,1,1,1,6,4,17
"Pondera County, MT",3,1,3,1,4,4,16
"Granite County, MT",4,1,1,1,6,3,16
"Jefferson County, MT",3,1,1,1,6,4,16
"Judith Basin County, MT",3,1,1,1,6,4,16
"Liberty County, MT",4,1,1,1,5,4,16
"Powell County, MT",3,1,1,1,6,4,16
"Teton County, MT",3,1,1,1,6,4,16
"Park County, MT",3,1,1,1,6,3,15
"Deer Lodge County, MT",3,1,1,1,3,4,13
"Glacier County, MT",3,1,1,1,3,4,13
"Silver Bow County, MT",3,1,1,1,3,4,13
"Hyde County, NC",4,7,7,10,2,9,39
"Pamlico County, NC",4,7,8,6,2,10,37
"Tyrrell County, NC",4,7,7,10,2,8,38
"Pender County, NC",4,6,8,6,3,8,35
"Beaufort County, NC",4,7,7,6,2,8,34
"Camden County, NC",4,7,7,6,2,8,34
"Craven County, NC",4,7,8,4,3,6,32
"Currituck County, NC",4,7,7,6,2,8,34
"Gates County, NC",6,6,8,4,2,7,33
"Jones County, NC",4,7,8,3,2,8,32
"Perquimans County, NC",4,7,7,4,2,8,32
"Chowan County, NC",4,7,8,4,2,6,31
"Pasquotank County, NC",4,7,7,4,2,7,31
"Greene County, NC",6,7,8,1,1,6,29
"Brunswick County, NC",4,7,4,4,2,8,29
"Carteret County, NC",4,7,3,6,1,9,30
"New Hanover County, NC",4,9,5,4,1,7,30
"Bertie County, NC",4,5,8,4,3,5,29
"Bladen County, NC",6,5,8,1,3,5,28
"Columbus County, NC",4,5,8,3,3,5,28
"Lenoir County, NC",6,7,8,1,1,5,28
"Pitt County, NC",6,6,8,3,1,5,29
"Wayne County, NC",6,7,8,1,1,5,28
"Cumberland County, NC",6,6,8,1,1,5,27
"Hertford County, NC",6,4,8,4,2,5,29
"Washington County, NC",4,7,6,4,2,5,28
"Wilson County, NC",6,6,8,1,1,5,27
"Dare County, NC",3,6,3,6,1,8,27
"Edgecombe County, NC",6,5,8,1,1,5,26
"Onslow County, NC",4,7,4,4,1,6,26
"Duplin County, NC",4,6,8,1,1,5,25
"Martin County, NC",4,4,8,4,1,5,26
"Hoke County, NC",6,2,8,1,1,5,23
"Robeson County, NC",6,2,8,1,1,5,23
"Sampson County, NC",6,2,8,1,1,5,23
"Scotland County, NC",6,2,8,1,1,5,23
"Harnett County, NC",6,2,8,1,1,5,23
"Northampton County, NC",4,4,7,1,2,5,23
"Anson County, NC",6,2,7,1,1,5,22
"Chatham County, NC",6,2,7,1,1,5,22
"Halifax County, NC",4,4,7,1,1,5,22
"Johnston County, NC",4,2,8,1,1,5,21
"Lee County, NC",6,2,7,1,1,5,22
"Durham County, NC",6,2,6,1,1,5,21
"Montgomery County, NC",4,2,7,1,1,5,20
"Nash County, NC",6,2,6,1,1,5,21
"Richmond County, NC",4,1,8,1,1,5,20
"Union County, NC",6,2,6,1,1,5,21
"Moore County, NC",4,1,7,1,1,5,19
"Alamance County, NC",6,2,4,1,1,5,19
"Granville County, NC",6,1,5,1,1,5,19
"Polk County, NC",3,1,7,1,1,5,18
"Transylvania County, NC",6,4,3,1,2,5,21
"Vance County, NC",6,4,3,1,1,5,20
"Cabarrus County, NC",6,1,4,1,1,5,18
"Franklin County, NC",6,1,4,1,1,5,18
"Wake County, NC",4,1,5,1,1,5,17
"Warren County, NC",4,2,4,1,1,5,17
"Caswell County, NC",6,2,3,1,1,4,17
"Mecklenburg County, NC",4,1,4,1,1,5,16
"Orange County, NC",4,1,4,1,1,5,16
"Randolph County, NC",4,1,5,1,1,4,16
"Stanly County, NC",4,1,4,1,1,5,16
"Wilkes County, NC",4,2,3,1,2,4,16
"Caldwell County, NC",4,1,3,1,1,5,15
"Catawba County, NC",4,1,3,1,1,5,15
"Cherokee County, NC",4,1,3,1,2,5,16
"Cleveland County, NC",4,1,3,1,1,5,15
"Davidson County, NC",4,1,3,1,1,5,15
"Davie County, NC",4,1,3,1,1,5,15
"Gaston County, NC",4,1,3,1,1,5,15
"Guilford County, NC",4,1,3,1,1,5,15
"Henderson County, NC",3,1,3,1,2,5,15
"Iredell County, NC",4,1,3,1,1,5,15
"Lincoln County, NC",4,1,3,1,1,5,15
"Rockingham County, NC",4,1,4,1,1,4,15
"Rowan County, NC",4,1,3,1,1,5,15
"Yadkin County, NC",4,1,3,1,1,5,15
"Alexander County, NC",4,1,3,1,1,4,14
"Alleghany County, NC",3,1,3,1,2,4,14
"Avery County, NC",3,1,3,1,2,4,14
"Burke County, NC",4,1,3,1,1,4,14
"Clay County, NC",3,1,3,1,2,4,14
"Forsyth County, NC",4,1,3,1,1,4,14
"Graham County, NC",3,1,3,1,2,4,14
"Haywood County, NC",3,1,3,1,2,4,14
"Jackson County, NC",3,1,3,1,2,4,14
"McDowell County, NC",3,1,3,1,1,5,14
"Macon County, NC",3,1,3,1,2,4,14
"Mitchell County, NC",3,1,3,1,2,4,14
"Person County, NC",4,1,3,1,1,4,14
"Rutherford County, NC",3,1,3,1,1,5,14
"Stokes County, NC",4,1,3,1,1,4,14
"Surry County, NC",4,1,3,1,1,4,14
"Swain County, NC",3,1,3,1,2,4,14
"Watauga County, NC",3,1,3,1,2,4,14
"Ashe County, NC",3,1,3,1,2,4,14
"Buncombe County, NC",3,1,3,1,2,4,14
"Madison County, NC",3,1,3,1,2,4,14
"Yancey County, NC",1,1,3,1,2,4,12
"Billings County, ND",4,2,4,1,3,4,18
"Bowman County, ND",4,1,4,1,3,5,18
"Hettinger County, ND",4,1,4,1,3,5,18
"McKenzie County, ND",4,2,3,1,4,4,18
"Slope County, ND",4,1,4,1,3,5,18
"Dunn County, ND",4,1,4,1,3,4,17
"Sioux County, ND",4,2,3,1,3,4,17
"Adams County, ND",4,1,3,1,3,4,16
"Golden Valley County, ND",4,1,3,1,3,4,16
"Grant County, ND",4,1,3,1,3,4,16
"McIntosh County, ND",4,2,3,1,1,5,16
"Sargent County, ND",4,2,3,1,1,5,16
"Stark County, ND",4,1,3,1,3,4,16
"Dickey County, ND",4,1,3,1,1,5,15
"Emmons County, ND",4,2,3,1,1,4,15
"LaMoure County, ND",4,1,3,1,1,5,15
"Richland County, ND",4,1,3,1,1,5,15
"Burleigh County, ND",4,1,3,1,1,4,14
"Cass County, ND",4,1,3,1,1,4,14
"Kidder County, ND",4,1,3,1,1,4,14
"Logan County, ND",4,1,3,1,1,4,14
"McLean County, ND",4,1,3,1,1,4,14
"Mercer County, ND",4,1,3,1,1,4,14
"Morton County, ND",4,1,3,1,1,4,14
"Oliver County, ND",4,1,3,1,1,4,14
"Ransom County, ND",4,1,3,1,1,4,14
"Stutsman County, ND",4,1,3,1,1,4,14
"Wells County, ND",4,1,3,1,1,4,14
"Barnes County, ND",3,1,3,1,1,4,13
"Benson County, ND",3,1,3,1,1,4,13
"Burke County, ND",3,1,3,1,1,4,13
"Cavalier County, ND",3,1,3,1,1,4,13
"Divide County, ND",4,1,3,1,1,4,14
"Eddy County, ND",3,1,3,1,1,4,13
"Foster County, ND",3,1,3,1,1,4,13
"Grand Forks County, ND",3,1,3,1,1,4,13
"Griggs County, ND",3,1,3,1,1,4,13
"McHenry County, ND",4,1,3,1,1,4,14
"Nelson County, ND",3,1,3,1,1,4,13
"Pembina County, ND",3,1,3,1,1,4,13
"Pierce County, ND",4,1,3,1,1,4,14
"Ramsey County, ND",3,1,3,1,1,4,13
"Rolette County, ND",3,1,3,1,1,4,13
"Sheridan County, ND",4,1,3,1,1,4,14
"Steele County, ND",3,1,3,1,1,4,13
"Towner County, ND",3,1,3,1,1,4,13
"Traill County, ND",3,1,3,1,1,4,13
"Walsh County, ND",3,1,3,1,1,4,13
"Williams County, ND",4,1,3,1,1,4,14
"Bottineau County, ND",3,1,3,1,1,4,13
"Mountrail County, ND",3,1,3,1,1,4,13
"Renville County, ND",3,1,3,1,1,4,13
"Ward County, ND",3,1,3,1,1,4,13
"Cherry County, NE",6,2,4,1,6,5,24
"Furnas County, NE",7,2,6,1,2,5,23
"Franklin County, NE",6,2,7,1,1,5,22
"Gosper County, NE",4,2,7,1,2,5,21
"Hall County, NE",6,2,7,1,1,5,22
"Harlan County, NE",6,2,7,1,1,5,22
"Nemaha County, NE",6,4,6,1,1,5,23
"Nuckolls County, NE",6,2,7,1,1,5,22
"Pawnee County, NE",6,2,7,1,1,5,22
"Richardson County, NE",6,2,7,1,1,5,22
"Webster County, NE",6,2,7,1,1,5,22
"Adams County, NE",6,2,6,1,1,5,21
"Clay County, NE",6,2,6,1,1,5,21
"Dundy County, NE",7,2,5,1,1,5,21
"Gage County, NE",6,2,6,1,1,5,21
"Garden County, NE",6,2,4,1,3,5,21
"Hitchcock County, NE",6,2,5,1,2,5,21
"Howard County, NE",6,2,6,1,1,5,21
"Jefferson County, NE",6,2,6,1,1,5,21
"Johnson County, NE",6,2,6,1,1,5,21
"Kearney County, NE",6,2,6,1,1,5,21
"Lancaster County, NE",6,2,6,1,1,5,21
"Merrick County, NE",6,2,6,1,1,5,21
"Otoe County, NE",6,2,6,1,1,5,21
"Phelps County, NE",6,2,6,1,1,5,21
"Red Willow County, NE",6,2,5,1,2,5,21
"Saline County, NE",6,2,6,1,1,5,21
"Thayer County, NE",6,2,6,1,1,5,21
"York County, NE",6,2,6,1,1,5,21
"Blaine County, NE",6,2,4,1,2,5,20
"Colfax County, NE",6,2,5,1,1,5,20
"Custer County, NE",4,1,5,1,3,5,19
"Douglas County, NE",6,2,5,1,1,5,20
"Fillmore County, NE",4,2,6,1,1,5,19
"Frontier County, NE",6,2,4,1,2,5,20
"Hamilton County, NE",4,2,6,1,1,5,19
"Holt County, NE",6,2,5,1,1,5,20
"Platte County, NE",6,2,5,1,1,5,20
"Sarpy County, NE",4,2,6,1,1,5,19
"Seward County, NE",4,2,6,1,1,5,19
"Sherman County, NE",6,1,6,1,1,5,20
"Thomas County, NE",6,2,4,1,2,5,20
"Boyd County, NE",4,2,5,1,1,5,18
"Buffalo County, NE",4,1,6,1,1,5,18
"Butler County, NE",4,1,6,1,1,5,18
"Cass County, NE",4,2,5,1,1,5,18
"Cheyenne County, NE",6,1,4,1,2,5,19
"Dawson County, NE",4,2,5,1,1,5,18
"Dodge County, NE",4,2,5,1,1,5,18
"Hayes County, NE",6,1,4,1,2,5,19
"Keith County, NE",6,2,4,1,1,5,19
"Keya Paha County, NE",4,1,6,1,1,5,18
"Loup County, NE",4,1,5,1,2,5,18
"Nance County, NE",4,2,5,1,1,5,18
"Polk County, NE",4,1,6,1,1,5,18
"Saunders County, NE",4,2,5,1,1,5,18
"Sheridan County, NE",4,1,4,1,3,5,18
"Sioux County, NE",6,1,4,1,2,5,19
"Thurston County, NE",4,4,4,1,1,5,19
"Arthur County, NE",6,1,3,1,2,5,18
"Banner County, NE",4,1,4,1,2,5,17
"Boone County, NE",4,1,5,1,1,5,17
"Box Butte County, NE",4,1,4,1,2,5,17
"Brown County, NE",4,1,5,1,1,5,17
"Burt County, NE",4,2,4,1,1,5,17
"Cedar County, NE",4,1,5,1,1,5,17
"Chase County, NE",6,1,4,1,1,5,18
"Cuming County, NE",4,2,4,1,1,5,17
"Dakota County, NE",4,2,4,1,1,5,17
"Dawes County, NE",4,1,4,1,2,5,17
"Deuel County, NE",6,1,4,1,1,5,18
"Garfield County, NE",4,1,5,1,1,5,17
"Greeley County, NE",4,1,5,1,1,5,17
"Knox County, NE",4,1,5,1,1,5,17
"Lincoln County, NE",4,1,3,1,3,5,17
"Logan County, NE",6,1,3,1,2,5,18
"McPherson County, NE",6,1,3,1,2,5,18
"Morrill County, NE",4,1,4,1,2,5,17
"Perkins County, NE",6,1,4,1,1,5,18
"Pierce County, NE",4,2,4,1,1,5,17
"Rock County, NE",4,1,5,1,1,5,17
"Stanton County, NE",4,2,4,1,1,5,17
"Valley County, NE",4,1,5,1,1,5,17
"Washington County, NE",4,1,5,1,1,5,17
"Wheeler County, NE",4,1,5,1,1,5,17
"Antelope County, NE",4,1,4,1,1,5,16
"Dixon County, NE",4,1,4,1,1,5,16
"Kimball County, NE",4,1,3,1,2,5,16
"Madison County, NE",4,1,4,1,1,5,16
"Scotts Bluff County, NE",4,1,4,1,1,5,16
"Wayne County, NE",4,1,4,1,1,5,16
"Grant County, NE",6,1,1,1,2,5,16
"Hooker County, NE",6,1,1,1,2,5,16
"Rockingham County, NH",3,4,1,4,1,4,17
"Strafford County, NH",3,4,1,3,1,4,16
"Belknap County, NH",3,4,1,1,1,4,14
"Cheshire County, NH",3,4,1,1,1,4,14
"Hillsborough County, NH",3,4,1,1,1,4,14
"Merrimack County, NH",3,4,1,1,1,4,14
"Sullivan County, NH",3,4,1,1,1,4,14
"Carroll County, NH",3,4,1,1,1,3,13
"Grafton County, NH",3,2,1,1,1,4,12
"Coos County, NH",3,2,1,1,1,3,11
"Cape May County, NJ",3,5,3,4,2,7,24
"Ocean County, NJ",4,2,3,6,3,5,23
"Salem County, NJ",4,4,4,6,1,5,24
"Atlantic County, NJ",3,4,3,4,3,5,22
"Burlington County, NJ",4,2,3,4,3,5,21
"Gloucester County, NJ",4,4,3,4,2,5,22
"Camden County, NJ",4,2,3,4,2,5,20
"Cumberland County, NJ",3,2,3,4,3,5,20
"Middlesex County, NJ",4,4,3,4,1,5,21
"Mercer County, NJ",4,4,3,3,1,5,20
"Monmouth County, NJ",4,2,3,4,1,5,19
"Hudson County, NJ",4,5,1,4,1,5,20
"Somerset County, NJ",4,4,3,1,1,5,18
"Bergen County, NJ",3,5,1,4,1,5,19
"Essex County, NJ",4,5,1,3,1,5,19
"Hunterdon County, NJ",4,2,3,1,1,5,16
"Passaic County, NJ",4,5,1,3,1,5,19
"Warren County, NJ",4,2,3,1,2,4,16
"Sussex County, NJ",3,2,3,1,2,4,15
"Union County, NJ",4,4,1,3,1,5,18
"Morris County, NJ",4,1,3,1,1,4,14
"Luna County, NM",9,2,8,1,6,5,31
"Chaves County, NM",9,1,8,1,6,6,31
"DoÃ±a Ana County, NM",9,2,8,1,6,5,31
"Hidalgo County, NM",9,2,6,1,7,5,30
"Lea County, NM",7,1,8,1,6,5,28
"Sierra County, NM",9,2,5,1,6,5,28
"Grant County, NM",6,1,4,1,7,5,24
"Socorro County, NM",7,1,4,1,6,5,24
"Quay County, NM",9,2,5,1,3,5,25
"Roosevelt County, NM",7,1,7,1,3,5,24
"Curry County, NM",7,1,6,1,3,5,23
"Sandoval County, NM",4,1,3,1,7,5,21
"Eddy County, NM",9,2,1,1,6,5,24
"Union County, NM",4,1,4,1,6,5,21
"Rio Arriba County, NM",3,1,3,1,7,4,19
"San Juan County, NM",6,1,3,1,6,4,21
"Santa Fe County, NM",4,1,3,1,6,4,19
"Valencia County, NM",7,1,4,1,3,5,21
"San Miguel County, NM",3,1,3,1,6,4,18
"Torrance County, NM",4,1,3,1,6,4,19
"Catron County, NM",7,1,1,1,6,4,20
"Guadalupe County, NM",7,1,1,1,5,5,20
"Otero County, NM",3,1,1,1,7,5,18
"Lincoln County, NM",3,1,1,1,6,5,17
"Colfax County, NM",3,1,1,1,6,4,16
"Mora County, NM",3,1,3,1,5,3,16
"Bernalillo County, NM",6,1,1,1,3,5,17
"De Baca County, NM",6,1,1,1,3,5,17
"Taos County, NM",3,1,3,1,3,4,15
"Harding County, NM",4,1,1,1,3,4,14
"Cibola County, NM",3,1,1,1,3,4,13
"Los Alamos County, NM",3,1,1,1,3,4,13
"McKinley County, NM",3,1,1,1,3,4,13
"Churchill County, NV",7,2,1,1,10,5,26
"Pershing County, NV",7,1,1,1,10,5,25
"Lincoln County, NV",7,1,1,1,9,5,24
"Elko County, NV",6,1,1,1,10,4,23
"Humboldt County, NV",6,1,1,1,10,4,23
"Lander County, NV",4,1,1,1,10,5,22
"Nye County, NV",6,1,1,1,9,5,23
"Washoe County, NV",4,1,1,1,10,4,21
"Clark County, NV",10,6,1,1,1,5,24
"Eureka County, NV",4,1,1,1,9,4,20
"Lyon County, NV",7,1,1,1,6,5,21
"White Pine County, NV",4,1,1,1,9,4,20
"Mineral County, NV",3,1,1,1,8,5,19
"Douglas County, NV",6,1,1,1,6,4,19
"Esmeralda County, NV",9,2,1,1,1,5,19
"Storey County, NV",3,1,1,1,6,4,16
"Carson City, NV",6,1,1,1,4,4,17
"Columbia County, NY",3,5,3,3,1,4,19
"Dutchess County, NY",3,5,3,3,1,4,19
"Greene County, NY",3,4,3,4,1,4,19
"Orange County, NY",3,4,3,3,2,4,19
"Rensselaer County, NY",3,5,3,3,1,4,19
"Richmond County, NY",4,5,1,4,1,5,20
"Suffolk County, NY",3,2,3,4,1,5,18
"Ulster County, NY",3,4,3,4,1,4,19
"Westchester County, NY",3,4,3,3,1,5,19
"Bronx County, NY",4,5,1,3,1,5,19
"Queens County, NY",4,5,1,3,1,5,19
"Saratoga County, NY",3,5,3,1,1,4,17
"Wayne County, NY",3,5,3,1,1,4,17
"Albany County, NY",3,4,3,1,1,4,16
"Allegany County, NY",3,4,3,1,1,4,16
"Cayuga County, NY",3,4,3,1,1,4,16
"Chautauqua County, NY",3,4,3,1,1,4,16
"Chemung County, NY",3,4,3,1,1,4,16
"Erie County, NY",3,4,3,1,1,4,16
"Genesee County, NY",3,4,3,1,1,4,16
"Kings County, NY",3,5,1,3,1,5,18
"Lewis County, NY",3,4,3,1,1,4,16
"Livingston County, NY",3,4,3,1,1,4,16
"Monroe County, NY",3,4,3,1,1,4,16
"Onondaga County, NY",3,4,3,1,1,4,16
"Ontario County, NY",3,4,3,1,1,4,16
"Oswego County, NY",3,4,3,1,1,4,16
"St. Lawrence County, NY",3,4,3,1,1,4,16
"Schenectady County, NY",3,4,3,1,1,4,16
"Seneca County, NY",3,4,3,1,1,4,16
"Tioga County, NY",3,4,3,1,1,4,16
"Warren County, NY",3,4,3,1,1,4,16
"Washington County, NY",3,4,3,1,1,4,16
"Yates County, NY",3,4,3,1,1,4,16
"New York County, NY",3,4,1,4,1,5,18
"Broome County, NY",3,2,3,1,1,4,14
"Cattaraugus County, NY",3,2,3,1,1,4,14
"Chenango County, NY",3,2,3,1,1,4,14
"Clinton County, NY",3,2,3,1,1,4,14
"Cortland County, NY",3,2,3,1,1,4,14
"Delaware County, NY",3,2,3,1,1,4,14
"Essex County, NY",3,2,3,1,1,4,14
"Franklin County, NY",3,2,3,1,1,4,14
"Fulton County, NY",3,2,3,1,1,4,14
"Herkimer County, NY",3,2,3,1,1,4,14
"Jefferson County, NY",3,2,3,1,1,4,14
"Madison County, NY",3,2,3,1,1,4,14
"Montgomery County, NY",3,2,3,1,1,4,14
"Nassau County, NY",3,4,1,4,1,4,17
"Niagara County, NY",3,2,3,1,1,4,14
"Oneida County, NY",3,2,3,1,1,4,14
"Orleans County, NY",3,2,3,1,1,4,14
"Otsego County, NY",3,2,3,1,1,4,14
"Schoharie County, NY",3,2,3,1,1,4,14
"Schuyler County, NY",3,2,3,1,1,4,14
"Steuben County, NY",3,2,3,1,1,4,14
"Sullivan County, NY",3,2,3,1,1,4,14
"Tompkins County, NY",3,2,3,1,1,4,14
"Wyoming County, NY",3,2,3,1,1,4,14
"Putnam County, NY",3,4,1,3,1,4,16
"Rockland County, NY",3,4,1,3,1,4,16
"Hamilton County, NY",3,2,1,1,1,2,10
"Gallia County, OH",6,7,3,1,2,5,24
"Meigs County, OH",6,7,3,1,2,5,24
"Montgomery County, OH",6,6,3,1,1,5,22
"Noble County, OH",4,5,4,1,2,5,21
"Guernsey County, OH",4,5,3,1,2,5,20
"Scioto County, OH",4,5,3,1,2,5,20
"Warren County, OH",6,5,3,1,1,5,21
"Fairfield County, OH",4,5,3,1,1,5,19
"Hamilton County, OH",4,5,3,1,1,5,19
"Jackson County, OH",4,4,3,1,2,5,19
"Pike County, OH",4,4,3,1,2,5,19
"Putnam County, OH",4,5,3,1,1,5,19
"Ross County, OH",4,4,3,1,2,5,19
"Van Wert County, OH",4,5,3,1,1,5,19
"Vinton County, OH",4,4,3,1,2,5,19
"Washington County, OH",4,4,3,1,2,5,19
"Brown County, OH",4,4,3,1,1,5,18
"Butler County, OH",4,4,3,1,1,5,18
"Champaign County, OH",4,4,3,1,1,5,18
"Coshocton County, OH",3,4,3,1,2,5,18
"Defiance County, OH",4,5,3,1,1,4,18
"Delaware County, OH",4,4,3,1,1,5,18
"Franklin County, OH",4,4,3,1,1,5,18
"Hardin County, OH",4,4,3,1,1,5,18
"Harrison County, OH",3,4,3,1,2,5,18
"Lawrence County, OH",3,4,3,1,2,5,18
"Lucas County, OH",4,5,3,1,1,4,18
"Madison County, OH",4,4,3,1,1,5,18
"Marion County, OH",4,4,3,1,1,5,18
"Morgan County, OH",3,4,3,1,2,5,18
"Muskingum County, OH",3,4,3,1,2,5,18
"Paulding County, OH",4,4,3,1,1,5,18
"Pickaway County, OH",4,4,3,1,1,5,18
"Sandusky County, OH",4,5,3,1,1,4,18
"Seneca County, OH",4,5,3,1,1,4,18
"Shelby County, OH",4,4,3,1,1,5,18
"Tuscarawas County, OH",3,4,3,1,2,5,18
"Union County, OH",4,4,3,1,1,5,18
"Wood County, OH",4,5,3,1,1,4,18
"Wyandot County, OH",4,4,3,1,1,5,18
"Adams County, OH",3,4,3,1,1,5,17
"Athens County, OH",3,2,3,1,2,5,16
"Auglaize County, OH",3,4,3,1,1,5,17
"Belmont County, OH",3,4,3,1,2,4,17
"Carroll County, OH",3,2,3,1,2,5,16
"Clark County, OH",4,2,3,1,1,5,16
"Clermont County, OH",4,2,3,1,1,5,16
"Clinton County, OH",3,4,3,1,1,5,17
"Darke County, OH",3,4,3,1,1,5,17
"Fayette County, OH",3,4,3,1,1,5,17
"Greene County, OH",3,4,3,1,1,5,17
"Hancock County, OH",4,4,3,1,1,4,17
"Henry County, OH",3,4,3,1,1,5,17
"Highland County, OH",3,4,3,1,1,5,17
"Hocking County, OH",3,4,3,1,1,5,17
"Huron County, OH",3,5,3,1,1,4,17
"Jefferson County, OH",3,4,3,1,2,4,17
"Licking County, OH",3,4,3,1,1,5,17
"Logan County, OH",3,4,3,1,1,5,17
"Mercer County, OH",3,4,3,1,1,5,17
"Monroe County, OH",3,2,3,1,2,5,16
"Morrow County, OH",3,4,3,1,1,5,17
"Ottawa County, OH",3,5,3,1,1,4,17
"Perry County, OH",3,4,3,1,1,5,17
"Preble County, OH",4,2,3,1,1,5,16
"Williams County, OH",4,4,3,1,1,4,17
"Allen County, OH",3,4,3,1,1,4,16
"Ashtabula County, OH",3,4,3,1,1,4,16
"Columbiana County, OH",3,4,3,1,1,4,16
"Crawford County, OH",3,2,3,1,1,5,15
"Cuyahoga County, OH",3,5,3,1,1,4,17
"Fulton County, OH",3,4,3,1,1,4,16
"Geauga County, OH",3,4,3,1,1,4,16
"Holmes County, OH",3,1,3,1,2,5,15
"Knox County, OH",3,2,3,1,1,5,15
"Lake County, OH",3,4,3,1,1,4,16
"Lorain County, OH",3,4,3,1,1,4,16
"Mahoning County, OH",3,4,3,1,1,4,16
"Medina County, OH",3,4,3,1,1,4,16
"Miami County, OH",3,2,3,1,1,5,15
"Stark County, OH",3,4,3,1,1,4,16
"Summit County, OH",3,4,3,1,1,4,16
"Trumbull County, OH",3,4,3,1,1,4,16
"Wayne County, OH",3,4,3,1,1,4,16
"Ashland County, OH",3,2,3,1,1,4,14
"Erie County, OH",3,2,3,1,1,4,14
"Portage County, OH",3,2,3,1,1,4,14
"Richland County, OH",3,2,3,1,1,4,14
"Grady County, OK",9,4,10,1,1,4,29
"Harmon County, OK",9,2,10,1,2,4,28
"Jefferson County, OK",9,4,10,1,1,4,29
"Kiowa County, OK",9,4,10,1,1,4,29
"Le Flore County, OK",7,4,9,1,3,4,28
"Okmulgee County, OK",7,4,9,1,3,4,28
"Pittsburg County, OK",7,4,9,1,3,4,28
"Pottawatomie County, OK",9,4,9,1,2,4,29
"Seminole County, OK",9,4,9,1,2,4,29
"Tillman County, OK",7,4,10,1,2,4,28
"Washita County, OK",9,4,10,1,1,4,29
"Woodward County, OK",7,4,9,1,3,4,28
"Alfalfa County, OK",9,4,9,1,1,4,28
"Atoka County, OK",7,4,9,1,2,4,27
"Choctaw County, OK",9,4,9,1,1,4,28
"Cleveland County, OK",7,4,9,1,2,4,27
"Comanche County, OK",7,4,10,1,1,4,27
"Ellis County, OK",7,2,9,1,3,4,26
"Garvin County, OK",7,4,10,1,1,4,27
"Hughes County, OK",7,4,9,1,2,4,27
"McIntosh County, OK",7,4,9,1,2,4,27
"Murray County, OK",7,4,10,1,1,4,27
"Okfuskee County, OK",7,4,9,1,2,4,27
"Osage County, OK",7,4,8,1,3,4,27
"Pawnee County, OK",7,4,9,1,2,4,27
"Tulsa County, OK",7,4,9,1,2,4,27
"Beaver County, OK",7,2,8,1,3,4,25
"Beckham County, OK",7,2,9,1,2,4,25
"Bryan County, OK",7,4,9,1,1,4,26
"Canadian County, OK",7,4,9,1,1,4,26
"Coal County, OK",7,2,9,1,2,4,25
"Dewey County, OK",7,2,9,1,2,4,25
"Garfield County, OK",7,4,9,1,1,4,26
"Harper County, OK",7,2,9,1,2,4,25
"Haskell County, OK",7,4,8,1,2,4,26
"Kingfisher County, OK",7,4,9,1,1,4,26
"Logan County, OK",7,4,9,1,1,4,26
"Love County, OK",7,2,10,1,1,4,25
"McClain County, OK",7,2,10,1,1,4,25
"Major County, OK",7,4,9,1,1,4,26
"Muskogee County, OK",7,4,9,1,1,4,26
"Noble County, OK",7,4,9,1,1,4,26
"Oklahoma County, OK",7,4,9,1,1,4,26
"Pontotoc County, OK",7,2,9,1,2,4,25
"Roger Mills County, OK",7,2,9,1,2,4,25
"Rogers County, OK",7,2,8,1,3,4,25
"Stephens County, OK",7,2,10,1,1,4,25
"Wagoner County, OK",7,4,8,1,2,4,26
"Blaine County, OK",7,2,9,1,1,4,24
"Caddo County, OK",7,2,9,1,1,4,24
"Carter County, OK",7,2,9,1,1,4,24
"Craig County, OK",6,4,8,1,2,4,25
"Creek County, OK",6,2,9,1,2,4,24
"Custer County, OK",7,2,9,1,1,4,24
"Grant County, OK",7,2,9,1,1,4,24
"Lincoln County, OK",7,2,9,1,1,4,24
"McCurtain County, OK",7,2,9,1,1,4,24
"Mayes County, OK",6,4,8,1,2,4,25
"Nowata County, OK",7,2,8,1,2,4,24
"Ottawa County, OK",6,4,8,1,2,4,25
"Payne County, OK",7,2,9,1,1,4,24
"Texas County, OK",7,2,8,1,3,4,25
"Washington County, OK",7,2,8,1,2,4,24
"Delaware County, OK",6,2,8,1,2,4,23
"Kay County, OK",7,2,8,1,1,4,23
"Sequoyah County, OK",6,2,8,1,2,4,23
"Cimarron County, OK",7,1,5,1,3,4,21
"Greer County, OK",9,4,1,1,2,4,21
"Jackson County, OK",9,4,1,1,2,4,21
"Johnston County, OK",9,4,1,1,2,4,21
"Cherokee County, OK",7,4,1,1,2,4,19
"Cotton County, OK",9,4,1,1,1,4,20
"Marshall County, OK",9,4,1,1,1,4,20
"Pushmataha County, OK",7,2,1,1,3,4,18
"Woods County, OK",9,4,1,1,1,4,20
"Latimer County, OK",7,2,1,1,2,4,17
"Adair County, OK",6,2,1,1,2,4,16
"Malheur County, OR",6,1,5,1,10,4,27
"Morrow County, OR",4,1,5,1,9,5,25
"Grant County, OR",6,1,4,1,9,4,25
"Umatilla County, OR",6,1,5,1,7,5,25
"Baker County, OR",4,1,4,1,9,4,23
"Jackson County, OR",4,1,4,1,8,5,23
"Josephine County, OR",7,1,3,1,7,5,24
"Gilliam County, OR",4,1,4,1,8,4,22
"Wallowa County, OR",4,1,3,1,9,4,22
"Union County, OR",4,1,4,1,7,4,21
"Harney County, OR",4,1,1,1,10,4,21
"Lake County, OR",6,1,1,1,9,4,22
"Douglas County, OR",4,2,1,3,7,4,21
"Lane County, OR",3,1,3,3,6,5,21
"Deschutes County, OR",3,1,3,1,6,4,18
"Klamath County, OR",4,1,1,1,8,4,19
"Wasco County, OR",6,1,1,1,7,4,20
"Clackamas County, OR",3,1,3,1,5,5,18
"Crook County, OR",4,1,1,1,7,4,18
"Sherman County, OR",4,1,1,1,6,5,18
"Wheeler County, OR",4,1,1,1,7,4,18
"Jefferson County, OR",4,1,1,1,6,4,17
"Multnomah County, OR",3,4,3,3,1,5,19
"Yamhill County, OR",4,2,3,1,1,4,15
"Hood River County, OR",4,1,1,1,4,4,15
"Linn County, OR",3,1,3,1,1,5,14
"Marion County, OR",3,1,3,1,1,5,14
"Washington County, OR",3,2,3,1,1,4,14
"Polk County, OR",3,1,3,1,1,4,13
"Clatsop County, OR",3,1,1,4,1,4,14
"Coos County, OR",3,2,1,3,1,4,14
"Lincoln County, OR",3,1,1,4,1,4,14
"Tillamook County, OR",3,1,1,4,1,4,14
"Benton County, OR",3,2,1,1,1,4,12
"Columbia County, OR",3,1,1,3,1,4,13
"Curry County, OR",1,1,1,3,1,4,11
"Montgomery County, PA",4,5,4,1,1,5,20
"Berks County, PA",4,4,3,1,2,5,19
"Bucks County, PA",3,5,3,3,1,5,20
"Cumberland County, PA",4,4,3,1,2,4,18
"Greene County, PA",3,4,3,1,2,5,18
"Juniata County, PA",4,2,3,1,2,5,17
"Perry County, PA",4,2,3,1,2,5,17
"Allegheny County, PA",3,4,3,1,2,4,17
"Armstrong County, PA",3,4,3,1,2,4,17
"Beaver County, PA",3,4,3,1,2,4,17
"Butler County, PA",3,4,3,1,2,4,17
"Centre County, PA",3,4,3,1,2,4,17
"Chester County, PA",3,4,3,1,1,5,17
"Clinton County, PA",3,4,3,1,2,4,17
"Delaware County, PA",4,5,1,3,1,5,19
"Fayette County, PA",3,4,3,1,2,4,17
"Franklin County, PA",4,2,3,1,2,4,16
"Jefferson County, PA",3,4,3,1,2,4,17
"Lackawanna County, PA",3,4,3,1,2,4,17
"Lancaster County, PA",4,1,4,1,1,5,16
"Lawrence County, PA",3,4,3,1,2,4,17
"Luzerne County, PA",3,4,3,1,2,4,17
"Mifflin County, PA",4,2,3,1,2,4,16
"Schuylkill County, PA",4,2,3,1,2,4,16
"Washington County, PA",3,4,3,1,2,4,17
"Westmoreland County, PA",3,4,3,1,2,4,17
"Adams County, PA",4,2,3,1,1,4,15
"Blair County, PA",3,2,3,1,2,4,15
"Bradford County, PA",3,4,3,1,1,4,16
"Cambria County, PA",3,2,3,1,2,4,15
"Cameron County, PA",3,4,3,1,1,4,16
"Carbon County, PA",3,4,3,1,1,4,16
"Clarion County, PA",3,2,3,1,2,4,15
"Clearfield County, PA",3,2,3,1,2,4,15
"Crawford County, PA",3,4,3,1,1,4,16
"Forest County, PA",3,4,3,1,1,4,16
"Huntingdon County, PA",3,2,3,1,2,4,15
"Indiana County, PA",3,2,3,1,2,4,15
"Lebanon County, PA",3,1,3,1,2,5,15
"Lehigh County, PA",3,4,3,1,1,4,16
"Lycoming County, PA",3,4,3,1,1,4,16
"Mercer County, PA",3,4,3,1,1,4,16
"Monroe County, PA",3,4,3,1,1,4,16
"Northampton County, PA",3,4,3,1,1,4,16
"Philadelphia County, PA",4,4,1,3,1,5,18
"Potter County, PA",3,4,3,1,1,4,16
"Somerset County, PA",3,2,3,1,2,4,15
"Venango County, PA",3,4,3,1,1,4,16
"Warren County, PA",3,4,3,1,1,4,16
"Wayne County, PA",3,2,3,1,2,4,15
"Wyoming County, PA",3,4,3,1,1,4,16
"Bedford County, PA",3,1,3,1,2,4,14
"Columbia County, PA",3,1,3,1,2,4,14
"Dauphin County, PA",3,1,3,1,2,4,14
"Elk County, PA",3,2,3,1,1,4,14
"Fulton County, PA",3,1,3,1,2,4,14
"McKean County, PA",3,2,3,1,1,4,14
"Montour County, PA",3,1,3,1,2,4,14
"Northumberland County, PA",3,1,3,1,2,4,14
"Pike County, PA",3,2,3,1,1,4,14
"Snyder County, PA",3,1,3,1,2,4,14
"Sullivan County, PA",3,2,3,1,1,4,14
"Susquehanna County, PA",3,2,3,1,1,4,14
"Tioga County, PA",3,2,3,1,1,4,14
"Union County, PA",3,1,3,1,2,4,14
"York County, PA",4,1,3,1,1,4,14
"Erie County, PA",3,1,3,1,1,4,13
"Bristol County, RI",3,4,1,4,1,5,18
"Kent County, RI",3,4,1,4,1,4,17
"Newport County, RI",3,4,1,4,1,4,17
"Washington County, RI",3,2,1,4,1,4,15
"Providence County, RI",3,1,1,3,1,4,13
"Beaufort County, SC",6,9,8,7,3,9,42
"Colleton County, SC",6,9,8,6,3,8,40
"Jasper County, SC",6,9,8,4,3,8,38
"Charleston County, SC",3,7,8,7,3,8,36
"Horry County, SC",4,6,8,4,3,8,33
"Georgetown County, SC",4,6,8,4,2,8,32
"Hampton County, SC",7,4,8,3,3,7,32
"Berkeley County, SC",6,4,8,4,3,6,31
"Dorchester County, SC",6,4,8,3,3,7,31
"Williamsburg County, SC",4,2,8,3,3,7,27
"Allendale County, SC",7,4,8,1,3,5,28
"Marion County, SC",6,4,8,1,3,6,28
"Clarendon County, SC",6,4,8,1,3,5,27
"Florence County, SC",6,4,8,1,3,5,27
"Bamberg County, SC",7,2,8,1,1,6,25
"Orangeburg County, SC",6,2,8,1,3,5,25
"Richland County, SC",9,2,8,1,1,5,26
"Barnwell County, SC",7,2,8,1,1,5,24
"Darlington County, SC",6,4,8,1,1,5,25
"Edgefield County, SC",7,2,8,1,1,5,24
"Lexington County, SC",7,2,8,1,1,5,24
"McCormick County, SC",7,2,8,1,1,5,24
"Saluda County, SC",7,2,8,1,1,5,24
"Sumter County, SC",6,1,8,1,3,5,24
"Aiken County, SC",6,2,8,1,1,5,23
"Dillon County, SC",6,2,8,1,1,5,23
"Fairfield County, SC",6,2,8,1,1,5,23
"Kershaw County, SC",6,2,8,1,1,5,23
"Lee County, SC",6,1,8,1,2,6,24
"Marlboro County, SC",6,2,8,1,1,5,23
"Calhoun County, SC",6,1,8,1,1,5,22
"Greenwood County, SC",6,1,8,1,1,5,22
"Union County, SC",6,1,8,1,1,5,22
"Chesterfield County, SC",6,1,8,1,1,5,22
"Lancaster County, SC",6,1,8,1,1,5,22
"Abbeville County, SC",6,1,7,1,1,5,21
"Chester County, SC",6,1,7,1,1,5,21
"Newberry County, SC",4,1,8,1,1,5,20
"Greenville County, SC",6,1,5,1,2,5,20
"Pickens County, SC",6,2,4,1,2,5,20
"Spartanburg County, SC",6,1,6,1,1,5,20
"York County, SC",6,1,6,1,1,5,20
"Anderson County, SC",6,2,4,1,1,5,19
"Laurens County, SC",6,1,5,1,1,5,19
"Cherokee County, SC",4,1,3,1,1,5,15
"Oconee County, SC",4,1,3,1,1,5,15
"Meade County, SD",6,2,4,1,6,5,24
"Pennington County, SD",6,1,4,1,6,5,23
"Haakon County, SD",6,2,5,1,4,5,23
"Butte County, SD",4,1,4,1,6,5,21
"Harding County, SD",4,1,4,1,6,5,21
"Jackson County, SD",6,2,5,1,3,5,22
"Jones County, SD",6,2,5,1,3,5,22
"Lyman County, SD",6,2,6,1,2,5,22
"Perkins County, SD",4,2,3,1,6,5,21
"Ziebach County, SD",6,2,4,1,4,5,22
"Charles Mix County, SD",6,2,5,1,2,5,21
"Custer County, SD",3,1,4,1,6,5,20
"Dewey County, SD",4,2,4,1,4,5,20
"Mellette County, SD",6,2,5,1,2,5,21
"Bennett County, SD",6,2,4,1,2,5,20
"Brule County, SD",6,2,5,1,1,5,20
"Corson County, SD",4,2,4,1,4,4,19
"Douglas County, SD",6,2,5,1,1,5,20
"Fall River County, SD",6,1,4,1,3,5,20
"Gregory County, SD",4,2,5,1,2,5,19
"Hughes County, SD",6,2,4,1,2,5,20
"Stanley County, SD",6,2,3,1,3,5,20
"Sully County, SD",6,2,4,1,2,5,20
"Tripp County, SD",6,2,5,1,1,5,20
"Yankton County, SD",6,2,5,1,1,5,20
"Bon Homme County, SD",4,2,5,1,1,5,18
"Faulk County, SD",4,2,4,1,2,5,18
"Hand County, SD",4,2,4,1,2,5,18
"Hyde County, SD",4,2,4,1,2,5,18
"Lawrence County, SD",3,1,4,1,5,4,18
"Potter County, SD",6,2,3,1,2,5,19
"Sanborn County, SD",4,2,5,1,1,5,18
"Beadle County, SD",4,2,4,1,1,5,17
"Buffalo County, SD",4,1,5,1,1,5,17
"Clay County, SD",4,1,5,1,1,5,17
"Davison County, SD",4,2,4,1,1,5,17
"Hanson County, SD",4,2,4,1,1,5,17
"Jerauld County, SD",4,2,4,1,1,5,17
"Todd County, SD",6,2,3,1,1,5,18
"Aurora County, SD",4,1,4,1,1,5,16
"Campbell County, SD",4,2,3,1,1,5,16
"Hutchinson County, SD",4,1,4,1,1,5,16
"Lincoln County, SD",4,1,4,1,1,5,16
"McCook County, SD",4,1,4,1,1,5,16
"McPherson County, SD",4,2,3,1,1,5,16
"Marshall County, SD",4,2,3,1,1,5,16
"Miner County, SD",3,2,4,1,1,5,16
"Oglala Lakota County, SD",1,1,4,1,3,5,15
"Roberts County, SD",4,2,3,1,1,5,16
"Spink County, SD",4,1,4,1,1,5,16
"Turner County, SD",4,1,4,1,1,5,16
"Union County, SD",4,1,4,1,1,5,16
"Walworth County, SD",4,2,3,1,1,5,16
"Brown County, SD",4,1,3,1,1,5,15
"Edmunds County, SD",4,1,3,1,1,5,15
"Kingsbury County, SD",3,2,3,1,1,5,15
"Minnehaha County, SD",4,1,3,1,1,5,15
"Brookings County, SD",3,1,3,1,1,5,14
"Clark County, SD",3,1,3,1,1,5,14
"Codington County, SD",3,1,3,1,1,5,14
"Day County, SD",3,1,3,1,1,5,14
"Deuel County, SD",3,1,3,1,1,5,14
"Grant County, SD",3,1,3,1,1,5,14
"Hamlin County, SD",3,1,3,1,1,5,14
"Lake County, SD",3,1,3,1,1,5,14
"Moody County, SD",3,1,3,1,1,5,14
"Shelby County, TN",7,7,8,1,1,5,29
"Dyer County, TN",6,7,8,1,1,5,28
"Lake County, TN",6,7,8,1,1,5,28
"Madison County, TN",6,7,8,1,1,5,28
"Tipton County, TN",6,7,8,1,1,5,28
"Chester County, TN",6,7,8,1,1,5,28
"Crockett County, TN",6,7,8,1,1,5,28
"Fayette County, TN",7,5,8,1,1,5,27
"Gibson County, TN",6,7,8,1,1,5,28
"Haywood County, TN",6,7,8,1,1,5,28
"Henderson County, TN",6,7,8,1,1,5,28
"Lauderdale County, TN",6,6,8,1,1,5,27
"McNairy County, TN",6,6,8,1,1,5,27
"Montgomery County, TN",6,7,8,1,1,5,28
"Obion County, TN",6,7,8,1,1,5,28
"Weakley County, TN",6,7,8,1,1,5,28
"Carroll County, TN",6,6,8,1,1,5,27
"Hardeman County, TN",6,5,8,1,1,5,26
"Hardin County, TN",6,6,8,1,1,5,27
"Stewart County, TN",6,7,7,1,1,5,27
"Benton County, TN",6,6,7,1,1,5,26
"Henry County, TN",6,6,7,1,1,5,26
"Perry County, TN",6,4,8,1,1,5,25
"Cheatham County, TN",6,5,7,1,1,5,25
"Decatur County, TN",6,4,7,1,1,5,24
"Houston County, TN",6,5,6,1,1,5,24
"Humphreys County, TN",4,5,7,1,1,5,23
"Macon County, TN",6,7,4,1,1,5,24
"Maury County, TN",6,4,7,1,1,5,24
"Trousdale County, TN",6,7,4,1,1,5,24
"Giles County, TN",6,4,6,1,1,5,23
"Hamilton County, TN",6,2,6,1,2,5,22
"Hickman County, TN",4,4,7,1,1,5,22
"Robertson County, TN",6,5,5,1,1,5,23
"Rutherford County, TN",6,4,6,1,1,5,23
"Sumner County, TN",6,5,5,1,1,5,23
"Williamson County, TN",6,5,5,1,1,5,23
"Davidson County, TN",6,5,4,1,1,5,22
"Dickson County, TN",4,4,6,1,1,5,21
"Jackson County, TN",6,5,4,1,1,5,22
"Lincoln County, TN",6,4,5,1,1,5,22
"Roane County, TN",4,4,5,1,2,5,21
"Smith County, TN",6,6,3,1,1,5,22
"Wayne County, TN",6,2,6,1,1,5,21
"Wilson County, TN",6,5,4,1,1,5,22
"Anderson County, TN",4,2,5,1,2,5,19
"Bedford County, TN",6,4,4,1,1,5,21
"Cannon County, TN",6,4,4,1,1,5,21
"Lawrence County, TN",4,2,6,1,1,5,19
"Lewis County, TN",4,2,6,1,1,5,19
"Marshall County, TN",6,4,4,1,1,5,21
"Sevier County, TN",3,1,7,1,2,5,19
"Clay County, TN",4,4,4,1,1,5,19
"Grundy County, TN",6,2,3,1,2,5,19
"Knox County, TN",4,2,4,1,2,5,18
"Loudon County, TN",4,4,3,1,2,5,19
"Marion County, TN",6,2,3,1,2,5,19
"Moore County, TN",4,2,5,1,1,5,18
"Scott County, TN",4,2,4,1,2,5,18
"Warren County, TN",6,4,3,1,1,5,20
"White County, TN",4,4,3,1,2,5,19
"Bledsoe County, TN",4,2,3,1,2,5,17
"Campbell County, TN",4,1,4,1,2,5,17
"Claiborne County, TN",4,2,3,1,2,5,17
"Cocke County, TN",4,2,3,1,2,5,17
"Coffee County, TN",4,4,3,1,1,5,18
"DeKalb County, TN",4,4,3,1,1,5,18
"Franklin County, TN",4,2,3,1,2,5,17
"Hamblen County, TN",4,2,3,1,2,5,17
"Jefferson County, TN",4,2,3,1,2,5,17
"McMinn County, TN",4,2,3,1,2,5,17
"Meigs County, TN",4,2,3,1,2,5,17
"Monroe County, TN",4,2,3,1,2,5,17
"Overton County, TN",4,4,3,1,1,5,18
"Rhea County, TN",4,2,3,1,2,5,17
"Sequatchie County, TN",4,2,3,1,2,5,17
"Blount County, TN",4,1,3,1,2,5,16
"Bradley County, TN",4,1,3,1,2,5,16
"Carter County, TN",3,2,3,1,2,5,16
"Fentress County, TN",3,2,3,1,2,5,16
"Grainger County, TN",4,1,3,1,2,5,16
"Greene County, TN",4,1,3,1,2,5,16
"Hancock County, TN",4,1,3,1,2,5,16
"Hawkins County, TN",4,1,3,1,2,5,16
"Polk County, TN",4,1,3,1,2,5,16
"Putnam County, TN",4,2,3,1,1,5,16
"Unicoi County, TN",3,2,3,1,2,5,16
"Union County, TN",4,1,3,1,2,5,16
"Van Buren County, TN",4,1,3,1,2,5,16
"Cumberland County, TN",3,1,3,1,2,5,15
"Johnson County, TN",3,1,3,1,2,5,15
"Morgan County, TN",3,1,3,1,2,5,15
"Pickett County, TN",3,2,3,1,1,5,15
"Sullivan County, TN",3,1,3,1,2,5,15
"Washington County, TN",3,1,3,1,2,5,15
"Cameron County, TX",6,10,8,4,1,7,36
"Galveston County, TX",6,7,9,4,1,8,35
"Willacy County, TX",10,4,10,4,1,7,36
"Kleberg County, TX",9,4,10,4,1,7,35
"Refugio County, TX",9,4,10,4,1,7,35
"Nueces County, TX",9,5,8,4,1,7,34
"Pecos County, TX",9,4,8,1,6,5,33
"Starr County, TX",10,6,10,1,1,6,34
"Webb County, TX",10,7,10,1,1,5,34
"Harris County, TX",9,4,10,3,1,6,33
"Hidalgo County, TX",10,5,8,1,1,7,32
"Jasper County, TX",7,5,10,1,1,7,31
"Live Oak County, TX",9,4,10,1,1,7,32
"San Patricio County, TX",9,4,8,4,1,7,33
"Waller County, TX",9,4,10,1,1,7,32
"Bee County, TX",9,4,9,1,1,7,31
"Brazoria County, TX",4,4,10,4,1,7,30
"Brewster County, TX",9,2,8,1,6,5,31
"Dimmit County, TX",10,5,10,1,1,5,32
"Goliad County, TX",9,4,10,1,1,6,31
"Grimes County, TX",9,4,10,1,2,6,32
"Llano County, TX",10,4,10,1,2,5,32
"Montgomery County, TX",9,4,10,1,1,6,31
"San Jacinto County, TX",7,2,10,1,1,8,29
"Tyler County, TX",7,2,10,1,1,8,29
"Zavala County, TX",10,5,10,1,1,5,32
"Aransas County, TX",9,10,1,6,1,8,35
"Atascosa County, TX",10,4,10,1,1,5,31
"Bexar County, TX",9,4,10,1,2,5,31
"Callahan County, TX",9,4,10,1,2,5,31
"Chambers County, TX",6,4,8,4,1,8,31
"Coleman County, TX",9,4,10,1,2,5,31
"Colorado County, TX",9,4,10,1,1,6,31
"DeWitt County, TX",10,4,10,1,1,5,31
"Fort Bend County, TX",9,2,9,1,1,7,29
"Haskell County, TX",9,4,10,1,2,5,31
"Jim Wells County, TX",9,4,9,1,1,6,30
"Kinney County, TX",10,5,9,1,1,5,31
"Lavaca County, TX",9,4,10,1,2,5,31
"Liberty County, TX",7,2,8,3,1,8,29
"Limestone County, TX",9,4,10,1,2,5,31
"Reagan County, TX",10,4,8,1,3,5,31
"Wilbarger County, TX",9,4,10,1,2,5,31
"Wilson County, TX",9,4,10,1,1,6,31
"Austin County, TX",9,4,10,1,1,5,30
"Bastrop County, TX",9,4,10,1,1,5,30
"Borden County, TX",9,4,8,1,3,5,30
"Bosque County, TX",9,4,10,1,1,5,30
"Brazos County, TX",9,4,10,1,1,5,30
"Caldwell County, TX",9,4,9,1,2,5,30
"Calhoun County, TX",4,4,8,4,1,7,28
"Collingsworth County, TX",9,4,8,1,3,5,30
"Comanche County, TX",9,4,10,1,1,5,30
"Concho County, TX",9,2,10,1,2,5,29
"Coryell County, TX",9,4,10,1,1,5,30
"Dallas County, TX",9,4,10,1,1,5,30
"Denton County, TX",9,4,10,1,1,5,30
"Erath County, TX",9,4,10,1,1,5,30
"Fayette County, TX",9,4,10,1,1,5,30
"Freestone County, TX",9,4,10,1,1,5,30
"Gonzales County, TX",9,4,10,1,1,5,30
"Hamilton County, TX",9,4,10,1,1,5,30
"Hood County, TX",9,4,10,1,1,5,30
"Jefferson County, TX",6,9,3,4,1,8,31
"Johnson County, TX",9,4,10,1,1,5,30
"Jones County, TX",9,4,9,1,2,5,30
"Karnes County, TX",9,4,10,1,1,5,30
"Kaufman County, TX",9,4,10,1,1,5,30
"La Salle County, TX",10,2,10,1,1,5,29
"Lee County, TX",9,4,10,1,1,5,30
"McCulloch County, TX",9,2,10,1,2,5,29
"Medina County, TX",9,4,8,1,2,6,30
"Navarro County, TX",9,4,10,1,1,5,30
"Rockwall County, TX",9,4,10,1,1,5,30
"Runnels County, TX",9,4,9,1,2,5,30
"Shelby County, TX",9,4,10,1,1,5,30
"Tarrant County, TX",9,4,10,1,1,5,30
"Taylor County, TX",9,4,9,1,2,5,30
"Throckmorton County, TX",9,4,10,1,1,5,30
"Tom Green County, TX",9,4,8,1,3,5,30
"Van Zandt County, TX",9,4,10,1,1,5,30
"Walker County, TX",9,2,10,1,1,6,29
"Wichita County, TX",9,4,10,1,1,5,30
"Wise County, TX",9,4,10,1,1,5,30
"Andrews County, TX",9,2,8,1,3,5,28
"Archer County, TX",9,4,10,1,1,4,29
"Bell County, TX",9,4,8,1,2,5,29
"Burleson County, TX",9,4,9,1,1,5,29
"Clay County, TX",9,4,10,1,1,4,29
"Collin County, TX",9,4,9,1,1,5,29
"Comal County, TX",7,2,10,1,2,5,27
"Cottle County, TX",9,4,8,1,2,5,29
"Dawson County, TX",9,2,8,1,3,5,28
"El Paso County, TX",9,2,8,1,3,5,28
"Fisher County, TX",9,4,8,1,2,5,29
"Gaines County, TX",9,2,8,1,3,5,28
"Gillespie County, TX",7,2,10,1,2,5,27
"Guadalupe County, TX",9,4,8,1,2,5,29
"Harrison County, TX",7,4,10,1,1,5,28
"Hays County, TX",7,2,10,1,2,5,27
"Houston County, TX",7,2,10,1,1,6,27
"Hunt County, TX",9,4,9,1,1,5,29
"Jackson County, TX",7,2,7,4,1,7,28
"Kerr County, TX",7,2,10,1,2,5,27
"Lamar County, TX",9,4,9,1,1,5,29
"Madison County, TX",9,2,10,1,1,5,28
"Matagorda County, TX",3,2,8,4,1,8,26
"Montague County, TX",9,4,10,1,1,4,29
"Panola County, TX",7,4,10,1,1,5,28
"Robertson County, TX",9,4,9,1,1,5,29
"Sutton County, TX",9,2,8,1,3,5,28
"Terry County, TX",9,2,8,1,3,5,28
"Travis County, TX",9,4,9,1,1,5,29
"Uvalde County, TX",9,4,9,1,1,5,29
"Washington County, TX",9,4,9,1,1,5,29
"Anderson County, TX",7,2,10,1,1,5,26
"Bandera County, TX",7,2,8,1,2,6,26
"Bowie County, TX",7,4,9,1,1,5,27
"Cass County, TX",7,4,9,1,1,5,27
"Cherokee County, TX",7,2,10,1,1,5,26
"Cooke County, TX",7,2,10,1,1,5,26
"Donley County, TX",9,2,8,1,3,4,27
"Falls County, TX",9,4,8,1,1,5,28
"Fannin County, TX",9,4,9,1,1,4,28
"Franklin County, TX",7,2,10,1,1,5,26
"Frio County, TX",10,2,8,1,1,5,27
"Grayson County, TX",7,4,9,1,1,5,27
"Leon County, TX",9,2,9,1,1,5,27
"Lubbock County, TX",9,2,8,1,2,5,27
"Lynn County, TX",9,2,8,1,2,5,27
"McLennan County, TX",9,4,8,1,1,5,28
"Milam County, TX",9,4,8,1,1,5,28
"Nacogdoches County, TX",9,2,9,1,1,5,27
"Nolan County, TX",9,2,8,1,2,5,27
"Orange County, TX",6,10,1,4,1,8,30
"Rusk County, TX",7,2,10,1,1,5,26
"San Augustine County, TX",7,2,10,1,1,5,26
"Smith County, TX",7,2,10,1,1,5,26
"Upshur County, TX",7,2,10,1,1,5,26
"Victoria County, TX",9,2,8,3,1,5,28
"Wharton County, TX",7,2,8,1,1,6,25
"Wheeler County, TX",7,2,8,1,3,5,26
"Williamson County, TX",9,4,8,1,1,5,28
"Armstrong County, TX",7,2,8,1,3,4,25
"Crosby County, TX",7,2,8,1,2,5,25
"Delta County, TX",7,2,9,1,1,5,25
"Ellis County, TX",7,4,8,1,1,5,26
"Floyd County, TX",7,2,8,1,3,4,25
"Gray County, TX",7,2,8,1,3,4,25
"Hill County, TX",9,4,8,1,1,5,28
"Hudspeth County, TX",9,2,3,1,6,5,26
"Hutchinson County, TX",9,2,8,1,2,4,26
"Red River County, TX",7,2,9,1,1,5,25
"Briscoe County, TX",7,2,8,1,2,4,24
"Hale County, TX",7,2,8,1,3,4,25
"Hockley County, TX",7,2,8,1,3,4,25
"Lipscomb County, TX",7,2,8,1,2,4,24
"Potter County, TX",7,2,8,1,2,5,25
"Roberts County, TX",7,2,8,1,2,4,24
"Terrell County, TX",10,5,1,1,6,5,28
"Cochran County, TX",7,2,8,1,2,4,24
"Duval County, TX",10,5,1,1,1,8,26
"Hansford County, TX",7,2,8,1,2,4,24
"Lamb County, TX",7,2,8,1,2,4,24
"Ochiltree County, TX",7,2,8,1,2,4,24
"Oldham County, TX",7,2,7,1,3,4,24
"Presidio County, TX",10,6,1,1,4,5,27
"Val Verde County, TX",10,5,1,1,5,5,27
"Brooks County, TX",10,5,1,1,1,7,25
"Carson County, TX",7,1,8,1,2,4,23
"Culberson County, TX",7,2,1,1,7,5,23
"Deaf Smith County, TX",7,2,6,1,3,4,23
"Moore County, TX",7,2,7,1,2,4,23
"Randall County, TX",7,2,7,1,2,4,23
"Swisher County, TX",7,1,8,1,2,4,23
"Bailey County, TX",7,1,7,1,2,4,22
"Crockett County, TX",9,4,1,1,5,5,25
"Edwards County, TX",10,5,1,1,3,5,25
"Hartley County, TX",7,1,6,1,3,4,22
"Jim Hogg County, TX",10,5,1,1,1,6,24
"Polk County, TX",9,4,1,1,1,8,24
"Reeves County, TX",9,2,1,1,6,5,24
"Sherman County, TX",7,1,7,1,2,4,22
"Trinity County, TX",9,4,1,1,1,8,24
"Castro County, TX",7,1,7,1,1,4,21
"Dallam County, TX",7,1,6,1,2,4,21
"Loving County, TX",10,4,1,1,3,5,24
"Martin County, TX",10,4,1,1,3,5,24
"Midland County, TX",10,4,1,1,3,5,24
"Ward County, TX",10,4,1,1,3,5,24
"Winkler County, TX",10,4,1,1,3,5,24
"Zapata County, TX",10,6,1,1,1,5,24
"Glasscock County, TX",9,4,1,1,3,5,23
"Hardin County, TX",6,2,1,3,1,8,21
"Howard County, TX",9,4,1,1,3,5,23
"Kenedy County, TX",10,5,1,1,1,5,23
"Maverick County, TX",10,5,1,1,1,5,23
"Newton County, TX",7,2,1,1,1,8,20
"San Saba County, TX",10,4,1,1,2,5,23
"Schleicher County, TX",9,4,1,1,3,5,23
"Upton County, TX",9,4,1,1,3,5,23
"Yoakum County, TX",9,2,2,1,3,5,22
"Blanco County, TX",9,4,1,1,2,5,22
"Childress County, TX",9,4,1,1,2,5,22
"Crane County, TX",9,2,1,1,3,5,21
"Eastland County, TX",9,4,1,1,2,5,22
"Ector County, TX",9,2,1,1,3,5,21
"Foard County, TX",9,4,1,1,2,5,22
"Hall County, TX",9,4,1,1,2,5,22
"King County, TX",9,4,1,1,2,5,22
"Knox County, TX",9,4,1,1,2,5,22
"McMullen County, TX",10,4,1,1,1,5,22
"Parmer County, TX",6,1,6,1,1,4,19
"Sabine County, TX",7,2,1,1,1,7,19
"Scurry County, TX",9,4,1,1,2,5,22
"Sterling County, TX",9,2,1,1,3,5,21
"Stonewall County, TX",9,4,1,1,2,5,22
"Kimble County, TX",9,2,1,1,2,5,20
"Baylor County, TX",9,4,1,1,1,5,21
"Brown County, TX",9,4,1,1,1,5,21
"Coke County, TX",9,2,1,1,2,5,20
"Dickens County, TX",9,2,1,1,2,5,20
"Hardeman County, TX",9,2,1,1,2,5,20
"Irion County, TX",9,2,1,1,2,5,20
"Jeff Davis County, TX",4,1,1,1,6,5,18
"Kendall County, TX",9,2,1,1,2,5,20
"Kent County, TX",9,2,1,1,2,5,20
"Lampasas County, TX",9,4,1,1,1,5,21
"Mason County, TX",9,2,1,1,2,5,20
"Menard County, TX",9,2,1,1,2,5,20
"Mills County, TX",9,4,1,1,1,5,21
"Mitchell County, TX",9,2,1,1,2,5,20
"Motley County, TX",9,2,1,1,2,5,20
"Palo Pinto County, TX",9,4,1,1,1,5,21
"Parker County, TX",9,4,1,1,1,5,21
"Rains County, TX",9,4,1,1,1,5,21
"Real County, TX",7,2,1,1,2,6,19
"Shackelford County, TX",9,4,1,1,1,5,21
"Stephens County, TX",9,4,1,1,1,5,21
"Young County, TX",9,4,1,1,1,5,21
"Angelina County, TX",9,2,1,1,1,5,19
"Burnet County, TX",9,2,1,1,1,5,19
"Garza County, TX",7,2,1,1,2,5,18
"Gregg County, TX",7,4,1,1,1,5,19
"Hemphill County, TX",7,2,1,1,2,5,18
"Henderson County, TX",7,4,1,1,1,5,19
"Jack County, TX",9,4,1,1,1,4,20
"Marion County, TX",7,4,1,1,1,5,19
"Somervell County, TX",9,2,1,1,1,5,19
"Camp County, TX",7,2,1,1,1,5,17
"Hopkins County, TX",7,2,1,1,1,5,17
"Morris County, TX",7,2,1,1,1,5,17
"Titus County, TX",7,2,1,1,1,5,17
"Wood County, TX",7,2,1,1,1,5,17
"Washington County, UT",7,2,5,1,9,5,29
"Tooele County, UT",7,2,5,1,9,4,28
"Juab County, UT",7,2,4,1,8,4,26
"Millard County, UT",7,1,4,1,9,4,26
"Salt Lake County, UT",7,2,5,1,7,4,26
"Davis County, UT",7,2,4,1,7,4,25
"Box Elder County, UT",4,1,4,1,9,4,23
"Utah County, UT",6,1,4,1,8,4,24
"San Juan County, UT",4,1,4,1,8,4,22
"Beaver County, UT",7,1,3,1,6,4,22
"Emery County, UT",6,1,4,1,6,4,22
"Uintah County, UT",7,1,4,1,6,4,23
"Cache County, UT",4,1,4,1,6,4,20
"Sevier County, UT",6,1,3,1,6,4,21
"Weber County, UT",4,1,4,1,6,4,20
"Carbon County, UT",4,1,3,1,6,4,19
"Duchesne County, UT",4,1,3,1,6,4,19
"Grand County, UT",6,2,1,1,6,4,20
"Iron County, UT",4,1,1,1,8,4,19
"Morgan County, UT",6,1,1,1,6,4,19
"Sanpete County, UT",4,1,1,1,7,4,18
"Wayne County, UT",6,1,1,1,6,4,19
"Garfield County, UT",3,1,1,1,7,4,17
"Summit County, UT",4,1,1,1,6,4,17
"Wasatch County, UT",6,1,1,1,6,4,19
"Kane County, UT",3,1,1,1,6,4,16
"Piute County, UT",4,1,1,1,6,4,17
"Rich County, UT",3,1,1,1,6,4,16
"Daggett County, UT",4,1,1,1,3,4,14
"Charles City County, VA",6,6,7,4,1,5,29
"Suffolk city, VA",6,4,8,4,2,5,29
"Isle of Wight County, VA",6,4,7,4,2,5,28
"Chesapeake city, VA",4,5,7,4,2,5,27
"Virginia Beach city, VA",4,5,7,4,2,5,27
"Henrico County, VA",6,5,8,3,1,4,27
"Northampton County, VA",4,7,3,4,1,6,25
"Southampton County, VA",4,4,8,4,1,5,26
"King and Queen County, VA",6,5,5,4,1,5,26
"King William County, VA",6,4,6,4,1,5,26
"New Kent County, VA",6,5,6,4,1,4,26
"Prince George County, VA",6,5,7,3,1,4,26
"Poquoson city, VA",4,5,1,6,1,9,26
"Lancaster County, VA",6,6,3,4,1,5,25
"Middlesex County, VA",6,6,3,4,1,5,25
"Accomack County, VA",3,5,3,7,1,5,24
"Essex County, VA",4,5,4,4,1,5,23
"Northumberland County, VA",4,6,3,4,1,5,23
"Chesterfield County, VA",6,2,6,3,1,4,22
"Gloucester County, VA",4,5,3,4,1,5,22
"Goochland County, VA",4,2,8,1,1,4,20
"Hanover County, VA",4,2,7,3,1,4,21
"James City County, VA",4,4,5,4,1,4,22
"Surry County, VA",4,4,4,4,1,5,22
"Sussex County, VA",4,4,7,1,1,4,21
"Newport News city, VA",4,5,1,7,2,5,24
"Greensville County, VA",4,1,7,1,1,5,19
"King George County, VA",4,4,4,4,1,4,21
"Powhatan County, VA",4,2,7,1,1,4,19
"Prince William County, VA",4,4,5,3,1,4,21
"Richmond County, VA",4,5,3,4,1,4,21
"Stafford County, VA",4,2,5,4,1,4,20
"Caroline County, VA",4,2,4,3,1,5,19
"Dinwiddie County, VA",4,2,6,1,1,4,18
"Fairfax County, VA",4,4,4,3,1,4,20
"Loudoun County, VA",4,2,5,1,2,4,18
"Hampton city, VA",4,5,1,4,2,5,21
"Norfolk city, VA",4,5,1,4,2,5,21
"Portsmouth city, VA",4,5,1,4,2,5,21
"Mathews County, VA",4,5,1,6,1,5,22
"Amelia County, VA",4,1,6,1,1,4,17
"Buckingham County, VA",4,1,6,1,1,4,17
"Fluvanna County, VA",4,2,5,1,1,4,17
"Henry County, VA",4,1,6,1,1,4,17
"Lunenburg County, VA",6,2,4,1,1,4,18
"Mecklenburg County, VA",6,2,4,1,1,4,18
"Orange County, VA",4,2,5,1,1,4,17
"Westmoreland County, VA",4,2,3,4,1,4,18
"York County, VA",4,5,1,4,1,5,20
"Colonial Heights city, VA",6,5,1,4,1,4,21
"Albemarle County, VA",4,2,4,1,1,4,16
"Brunswick County, VA",4,1,5,1,1,4,16
"Clarke County, VA",3,2,4,1,2,4,16
"Craig County, VA",4,2,3,1,2,4,16
"Culpeper County, VA",4,2,4,1,1,4,16
"Louisa County, VA",4,2,4,1,1,4,16
"Madison County, VA",4,1,4,1,2,4,16
"Rappahannock County, VA",4,1,4,1,2,4,16
"Hopewell city, VA",6,5,1,3,1,4,20
"Williamsburg city, VA",4,5,1,3,1,5,19
"Amherst County, VA",4,1,4,1,1,4,15
"Bedford County, VA",4,1,3,1,2,4,15
"Botetourt County, VA",4,1,3,1,2,4,15
"Carroll County, VA",4,1,3,1,2,4,15
"Charlotte County, VA",6,1,3,1,1,4,16
"Cumberland County, VA",4,1,4,1,1,4,15
"Fauquier County, VA",3,2,4,1,1,4,15
"Frederick County, VA",4,1,3,1,2,4,15
"Greene County, VA",4,2,3,1,1,4,15
"Halifax County, VA",4,1,4,1,1,4,15
"Lee County, VA",4,1,3,1,2,4,15
"Nelson County, VA",4,1,3,1,2,4,15
"Nottoway County, VA",4,1,4,1,1,4,15
"Page County, VA",4,1,3,1,2,4,15
"Prince Edward County, VA",4,1,4,1,1,4,15
"Rockbridge County, VA",4,1,3,1,2,4,15
"Scott County, VA",4,1,3,1,2,4,15
"Shenandoah County, VA",4,1,3,1,2,4,15
"Spotsylvania County, VA",4,2,3,1,1,4,15
"Warren County, VA",4,1,3,1,2,4,15
"Petersburg city, VA",6,5,1,1,1,4,18
"Appomattox County, VA",4,1,3,1,1,4,14
"Augusta County, VA",3,1,3,1,2,4,14
"Bath County, VA",3,1,3,1,2,4,14
"Bland County, VA",3,1,3,1,2,4,14
"Buchanan County, VA",3,1,3,1,2,4,14
"Campbell County, VA",4,1,3,1,1,4,14
"Dickenson County, VA",3,1,3,1,2,4,14
"Franklin County, VA",4,1,3,1,1,4,14
"Giles County, VA",3,1,3,1,2,4,14
"Grayson County, VA",3,1,3,1,2,4,14
"Montgomery County, VA",3,1,3,1,2,4,14
"Patrick County, VA",4,1,3,1,1,4,14
"Pittsylvania County, VA",4,1,3,1,1,4,14
"Pulaski County, VA",3,1,3,1,2,4,14
"Rockingham County, VA",3,1,3,1,2,4,14
"Russell County, VA",3,1,3,1,2,4,14
"Smyth County, VA",3,1,3,1,2,4,14
"Tazewell County, VA",3,1,3,1,2,4,14
"Washington County, VA",3,1,3,1,2,4,14
"Wise County, VA",3,1,3,1,2,4,14
"Wythe County, VA",3,1,3,1,2,4,14
"Franklin city, VA",6,4,1,1,1,4,17
"Richmond city, VA",6,2,1,3,1,4,17
"Alexandria city, VA",4,2,1,3,1,5,16
"Falls Church city, VA",4,4,1,1,1,5,16
"Manassas city, VA",4,4,1,1,1,5,16
"Floyd County, VA",3,1,3,1,1,4,13
"Highland County, VA",1,1,3,1,2,4,12
"Fairfax city, VA",4,4,1,1,1,4,15
"Manassas Park city, VA",4,4,1,1,1,4,15
"Galax city, VA",4,2,1,1,1,5,14
"Alleghany County, VA",4,1,1,1,2,4,13
"Arlington County, VA",4,2,1,1,1,4,13
"Roanoke County, VA",4,1,1,1,2,4,13
"Charlottesville city, VA",4,2,1,1,1,4,13
"Emporia city, VA",4,1,1,1,1,5,13
"Fredericksburg city, VA",4,2,1,1,1,4,13
"Buena Vista city, VA",4,1,1,1,1,5,13
"Covington city, VA",4,1,1,1,1,5,13
"Lexington city, VA",4,1,1,1,1,5,13
"Winchester city, VA",4,1,1,1,1,5,13
"Danville city, VA",4,1,1,1,1,4,12
"Lynchburg city, VA",4,1,1,1,1,4,12
"Martinsville city, VA",4,1,1,1,1,4,12
"Roanoke city, VA",4,1,1,1,1,4,12
"Salem city, VA",4,1,1,1,1,4,12
"Radford city, VA",3,1,1,1,1,5,12
"Staunton city, VA",3,1,1,1,1,5,12
"Waynesboro city, VA",3,1,1,1,1,5,12
"Bristol city, VA",3,1,1,1,1,4,11
"Harrisonburg city, VA",3,1,1,1,1,4,11
"Norton city, VA",3,1,1,1,1,4,11
"Chittenden County, VT",3,4,1,1,1,4,14
"Rutland County, VT",3,4,1,1,1,3,13
"Washington County, VT",3,4,1,1,1,3,13
"Windham County, VT",3,4,1,1,1,3,13
"Windsor County, VT",3,4,1,1,1,3,13
"Addison County, VT",3,2,1,1,1,3,11
"Bennington County, VT",3,2,1,1,1,3,11
"Caledonia County, VT",3,4,1,1,1,2,12
"Grand Isle County, VT",3,4,1,1,1,1,11
"Orleans County, VT",3,2,1,1,1,2,10
"Essex County, VT",3,2,1,1,1,1,9
"Franklin County, VT",1,1,1,1,1,3,8
"Orange County, VT",3,2,1,1,1,1,9
"Lamoille County, VT",1,1,1,1,1,2,7
"Grant County, WA",4,1,5,1,9,5,25
"Benton County, WA",4,1,5,1,8,5,24
"Yakima County, WA",4,1,4,1,9,5,24
"Douglas County, WA",6,1,4,1,8,4,24
"Lincoln County, WA",4,1,4,1,8,4,22
"Okanogan County, WA",4,1,4,1,8,4,22
"Chelan County, WA",4,1,4,1,7,4,21
"Ferry County, WA",4,1,4,1,7,4,21
"Kittitas County, WA",4,1,3,1,7,4,20
"Klickitat County, WA",4,1,1,1,8,4,19
"Walla Walla County, WA",6,1,6,1,1,5,20
"Asotin County, WA",6,1,1,1,6,4,19
"Franklin County, WA",6,1,5,1,1,5,19
"Snohomish County, WA",3,2,3,4,3,4,19
"Stevens County, WA",4,1,1,1,7,4,18
"Clark County, WA",3,2,3,3,3,4,18
"Columbia County, WA",6,1,5,1,1,4,18
"Pacific County, WA",3,4,3,4,1,4,19
"Pierce County, WA",3,2,3,3,3,4,18
"Adams County, WA",4,1,4,1,1,5,16
"Cowlitz County, WA",3,2,1,4,4,4,18
"Garfield County, WA",4,1,1,1,6,4,17
"Island County, WA",3,2,3,4,1,4,17
"Lewis County, WA",4,2,1,1,5,4,17
"Pend Oreille County, WA",4,1,1,1,6,4,17
"Skamania County, WA",4,1,1,1,6,4,17
"Skagit County, WA",3,2,1,4,3,4,17
"Spokane County, WA",4,1,4,1,1,4,15
"Whitman County, WA",4,1,4,1,1,4,15
"King County, WA",3,2,1,3,3,4,16
"Whatcom County, WA",3,1,3,3,1,4,15
"Kitsap County, WA",3,2,1,4,1,4,15
"Thurston County, WA",3,2,1,4,1,4,15
"Clallam County, WA",3,1,1,4,1,4,14
"Grays Harbor County, WA",3,1,1,4,1,4,14
"Jefferson County, WA",3,1,1,4,1,4,14
"Mason County, WA",3,1,1,4,1,4,14
"Wahkiakum County, WA",3,1,1,4,1,4,14
"San Juan County, WA",3,1,1,3,1,4,13
"Douglas County, WI",3,5,3,1,3,4,19
"Bayfield County, WI",3,4,3,1,3,4,18
"Oneida County, WI",3,4,3,1,3,4,18
"Price County, WI",3,4,3,1,3,4,18
"Rock County, WI",4,5,3,1,1,4,18
"Rusk County, WI",3,4,3,1,3,4,18
"Sawyer County, WI",3,4,3,1,3,4,18
"Walworth County, WI",3,5,4,1,1,4,18
"Washburn County, WI",3,5,3,1,2,4,18
"Adams County, WI",4,4,3,1,1,4,17
"Crawford County, WI",3,5,3,1,1,4,17
"Eau Claire County, WI",4,4,3,1,1,4,17
"Forest County, WI",3,2,3,1,3,4,16
"Green County, WI",3,4,3,1,1,5,17
"Jefferson County, WI",3,5,3,1,1,4,17
"Juneau County, WI",4,4,3,1,1,4,17
"La Crosse County, WI",4,4,3,1,1,4,17
"Lafayette County, WI",3,4,3,1,1,5,17
"Milwaukee County, WI",3,5,3,1,1,4,17
"Racine County, WI",3,5,3,1,1,4,17
"Vernon County, WI",3,4,3,1,1,5,17
"Waukesha County, WI",3,5,3,1,1,4,17
"Ashland County, WI",3,4,3,1,1,4,16
"Barron County, WI",3,4,3,1,1,4,16
"Buffalo County, WI",3,4,3,1,1,4,16
"Chippewa County, WI",3,4,3,1,1,4,16
"Clark County, WI",3,4,3,1,1,4,16
"Columbia County, WI",3,4,3,1,1,4,16
"Dane County, WI",3,4,3,1,1,4,16
"Dodge County, WI",3,4,3,1,1,4,16
"Dunn County, WI",3,4,3,1,1,4,16
"Florence County, WI",3,2,3,1,2,4,15
"Fond du Lac County, WI",3,4,3,1,1,4,16
"Grant County, WI",3,4,3,1,1,4,16
"Green Lake County, WI",3,4,3,1,1,4,16
"Iowa County, WI",3,4,3,1,1,4,16
"Jackson County, WI",3,4,3,1,1,4,16
"Kenosha County, WI",3,4,3,1,1,4,16
"Lincoln County, WI",3,2,3,1,2,4,15
"Marinette County, WI",3,1,3,1,3,4,15
"Marquette County, WI",3,4,3,1,1,4,16
"Oconto County, WI",3,4,3,1,1,4,16
"Pepin County, WI",3,4,3,1,1,4,16
"Richland County, WI",3,4,3,1,1,4,16
"St. Croix County, WI",3,2,3,1,2,4,15
"Sauk County, WI",3,4,3,1,1,4,16
"Sheboygan County, WI",3,4,3,1,1,4,16
"Taylor County, WI",3,4,3,1,1,4,16
"Trempealeau County, WI",3,4,3,1,1,4,16
"Washington County, WI",3,4,3,1,1,4,16
"Burnett County, WI",3,2,3,1,1,4,14
"Door County, WI",3,2,3,1,1,4,14
"Kewaunee County, WI",3,2,3,1,1,4,14
"Langlade County, WI",3,2,3,1,1,4,14
"Monroe County, WI",3,2,3,1,1,4,14
"Ozaukee County, WI",3,2,3,1,1,4,14
"Pierce County, WI",3,2,3,1,1,4,14
"Waupaca County, WI",3,2,3,1,1,4,14
"Waushara County, WI",3,2,3,1,1,4,14
"Wood County, WI",3,2,3,1,1,4,14
"Brown County, WI",3,1,3,1,1,4,13
"Calumet County, WI",3,1,3,1,1,4,13
"Iron County, WI",3,4,1,1,2,4,15
"Manitowoc County, WI",3,1,3,1,1,4,13
"Marathon County, WI",3,1,3,1,1,4,13
"Outagamie County, WI",3,1,3,1,1,4,13
"Polk County, WI",3,1,3,1,1,4,13
"Portage County, WI",3,1,3,1,1,4,13
"Shawano County, WI",3,1,3,1,1,4,13
"Winnebago County, WI",3,1,3,1,1,4,13
"Vilas County, WI",3,2,1,1,2,4,13
"Menominee County, WI",3,1,1,1,1,4,11
"Mason County, WV",6,7,3,1,2,4,23
"Wood County, WV",4,5,4,1,2,5,21
"Gilmer County, WV",4,5,4,1,2,4,20
"Lincoln County, WV",4,5,4,1,2,4,20
"Putnam County, WV",4,5,4,1,2,4,20
"Wayne County, WV",4,5,4,1,2,4,20
"Cabell County, WV",4,4,4,1,2,4,19
"Jackson County, WV",4,5,3,1,2,4,19
"Kanawha County, WV",4,4,4,1,2,4,19
"Pleasants County, WV",4,4,4,1,2,4,19
"Ritchie County, WV",4,4,4,1,2,4,19
"Berkeley County, WV",4,2,4,1,2,4,17
"Braxton County, WV",3,4,4,1,2,4,18
"Brooke County, WV",3,4,3,1,2,5,18
"Hancock County, WV",3,4,3,1,2,5,18
"Jefferson County, WV",4,2,4,1,2,4,17
"Marion County, WV",4,4,3,1,2,4,18
"Morgan County, WV",4,2,4,1,2,4,17
"Tyler County, WV",3,4,4,1,2,4,18
"Wirt County, WV",3,4,4,1,2,4,18
"Boone County, WV",4,2,3,1,2,4,16
"Calhoun County, WV",3,4,3,1,2,4,17
"Doddridge County, WV",3,4,3,1,2,4,17
"Harrison County, WV",3,4,3,1,2,4,17
"Marshall County, WV",3,4,3,1,2,4,17
"Mineral County, WV",4,2,3,1,2,4,16
"Monongalia County, WV",3,4,3,1,2,4,17
"Nicholas County, WV",3,4,3,1,2,4,17
"Ohio County, WV",3,4,3,1,2,4,17
"Roane County, WV",3,4,3,1,2,4,17
"Barbour County, WV",3,2,3,1,2,4,15
"Fayette County, WV",3,2,3,1,2,4,15
"Grant County, WV",4,1,3,1,2,4,15
"Hardy County, WV",4,1,3,1,2,4,15
"Logan County, WV",4,5,1,1,2,4,17
"Preston County, WV",3,2,3,1,2,4,15
"Randolph County, WV",3,2,3,1,2,4,15
"Tucker County, WV",3,2,3,1,2,4,15
"Upshur County, WV",3,2,3,1,2,4,15
"Wetzel County, WV",3,2,3,1,2,4,15
"Greenbrier County, WV",3,1,3,1,2,4,14
"Hampshire County, WV",4,1,3,1,2,3,14
"Mercer County, WV",3,1,3,1,2,4,14
"Mingo County, WV",4,4,1,1,2,4,16
"Monroe County, WV",3,1,3,1,2,4,14
"Raleigh County, WV",3,1,3,1,2,4,14
"Summers County, WV",3,1,3,1,2,4,14
"Taylor County, WV",4,4,1,1,2,4,16
"Clay County, WV",3,4,1,1,2,4,15
"Pendleton County, WV",3,1,3,1,2,3,13
"Webster County, WV",3,4,1,1,2,4,15
"Lewis County, WV",3,2,1,1,2,4,13
"Pocahontas County, WV",1,1,3,1,2,3,11
"McDowell County, WV",3,1,1,1,2,4,12
"Wyoming County, WV",3,1,1,1,2,4,12
"Natrona County, WY",4,1,3,1,7,4,20
"Sheridan County, WY",6,1,4,1,6,4,22
"Fremont County, WY",4,1,3,1,6,4,19
"Park County, WY",4,1,3,1,6,4,19
"Platte County, WY",6,1,3,1,6,4,21
"Big Horn County, WY",4,1,3,1,6,4,19
"Niobrara County, WY",6,1,4,1,4,4,20
"Washakie County, WY",4,1,3,1,6,4,19
"Albany County, WY",3,1,3,1,6,4,18
"Converse County, WY",6,1,1,1,6,4,19
"Crook County, WY",4,1,1,1,7,4,18
"Hot Springs County, WY",6,1,3,1,4,4,19
"Johnson County, WY",4,1,1,1,7,4,18
"Campbell County, WY",4,1,1,1,6,4,17
"Carbon County, WY",3,1,1,1,7,4,17
"Goshen County, WY",6,1,4,1,2,4,18
"Weston County, WY",4,1,1,1,6,4,17
"Sweetwater County, WY",3,1,1,1,6,4,16
"Laramie County, WY",3,1,3,1,3,4,15
"Lincoln County, WY",3,1,1,1,6,4,16
"Sublette County, WY",3,1,1,1,6,4,16
"Teton County, WY",3,1,1,1,6,4,16
"Uinta County, WY",3,1,1,1,4,4,14
